волыночка	волынка
воришка	вор
ворюга	вор
восьмерочка	восьмерка
вповалочку	вповалку
всадничек	всадник
вулканчик	вулкан
конфеточка	конфета
конфетка	конфета
конфликтик	конфликт
концептуальненько	концептуально
копеечка	копейка
Коринка	Корина
коротенько	коротко
коротковато	коротко
коротышечка	коротышка
косыночка	косынка
кофточка	кофта
красноморденький	красномордый
кратенький	краткий
кремчик	крем
крепенький	крепкий
крепковатый	крепкий
крестьяночка	крестьянка
криночка	кринка
кроссовочка	кроссовка
крошечка	кроха
крошка	кроха
кругловатый	круглый
кругленький	круглый
кругляшечка	кругляшка
крутенько	круто
крутоватенько	круто
крутовато	круто
крыска	крыса
крючочек	крючок
Ксюшка	Ксюша
Ксюшенька	Ксюша
Ксюшечка	Ксюша
кузовок	кузов
кузовочек	кузов
куличик	кулич
курчавенький	курчавый
кухарочка	кухарка
кухонька	кухня
ладненько	ладно
ладнехонько	ладно
легонечко	легко
легонько	легко
легошенько	легко
лесок	лес
лесочек	лес
Лидка	Лида
Лидочка	Лида
лилипуточка	лилипутка
лимончик	лимон
парничок	парник
паспорточек	паспорт
паутиночка	паутинка
пациентик	пациент
Пашка	Паша
Пашенька	Паша
пегенький	пегий
пелеринка	пелерина
пелериночка	пелерина
перевальчик	перевал
перевозочка	перевозка
переживаньице	переживание
расчудесненький	расчудесный
резковатый	резкий
резковато	резко
репертуарчик	репертуар
решеточка	решетка
рисочка	риска
ритуальчик	ритуал
ровненький	ровный
ровнехонький	ровный
Ромочка	Рома
росленький	рослый
россияночка	россиянка
ротик	рот
роточек	рот
рубильничек	рубильник
рублик	рубль
рукавчик	рукав
ручеечек	ручей
ручеек	ручей
рыхленький	рыхлый
рыхловатый	рыхлый
рюкзачок	рюкзак
рябинушка	рябина
рябинка	рябина
рязаночка	рязанка
галечка	галька
гаражик	гараж
гармошечка	гармошка
гарнизончик	гарнизон
генеральчик	генерал
гимнасточка	гимнастка
гитарка	гитара
Глашечка	Глаша
глоточек	глоток
глуховато	глухо
глянцеватый	глянцевый
гнусненький	гнусный
гнусноватый	гнусный
говорочек	говор
городишко	город
городок	город
прегорько	горько
горьковато	горько
горенько	горько
горьконько	горько
горькохонько	горько
лисичка	лиса
личиночка	личинка
ложбиночка	ложбинка
лоскуток	лоскут
лоскутик	лоскут
Любушка	Люба
Любаша	Люба
Любочка	Люба
Любанька	Люба
Людмилка	Людмила
Людмилочка	Людмила
люстрочка	люстра
малюточка	малютка
малявочка	малявка
мамочка	мама
мамашка	мама
Маменька	мама
мамуся	мама
маманька	маманя
маманечка	маманя
Марфушка	Марфуша
матерок	мат
маячок	маяк
медсестричка	медсестра
мероприятьице	мероприятие
метелочка	метелка
метисочка	метиска
перестроечка	перестройка
перстенечек	перстенек
пестровато	пестро
пестренько	пестро
петардочка	петарда
петелька	петля
печенка	печень
печурочка	печь
печка	печь
печурка	печь
пиджачок	пиджак
пиздатенько	пиздато
пионерочка	пионерка
пистолетик	пистолет
плетка	плеть
плеточка	плеть
плетушка	плеть
пломбочка	пломба
плотик	плот
плот	плотик
плюгавенький	плюгавый
побывочка	побывка
поведеньице	поведение
повесточка	повестка
поганочка	поганка
сапожок	сапог
сапожище	сапог
сбочку	сбоку
свежевато	свежо
свеженько	свежо
волюшка	воля
вонюченький	вонючий
вприсядочку	вприсядку
всячинка	всячина
вторничек	вторник
входик	вход
конусик	конус
концертик	концерт
корешочек	корешок
коровенка	корова
коровушка	корова
коровка	корова
косоглазенький	косоглазый
костлявенький	костлявый
косулечка	косуля
котомочка	котомка
кошмарненько	кошмарно
красивенький	красивый
красотулечка	красотка
красоточка	красотка
кредитик	кредит
крестик	крест
кровинушка	кровинка
кубик	куб
кубочек	кубок
Кузя	Кузьма
кумушка	кума
купальничек	купальник
курносенький	курносый
куценький	куцый
кучерявенький	кучерявый
лампочка	лампа
ласковенький	ласковый
лебедушка	лебеда
ледок	лед
ледокольчик	ледокол
лексикончик	лексикон
Лерочка	Лера
Лешенька	Леша
Лизонька	Лиза
Лизочка	Лиза
Лизанька	Лиза
парнишечка	парень
парнишка	парень
паренек	парень
парниша	парень
пастушок	пастух
пачечка	пачка
паштетик	паштетик
пеленочка	пеленка
перевязочка	перевязка
расчетик	расчет
расширеньице	расширение
рваненький	рваный
режимчик	режим
резвенько	резво
резвехонько	резво
рекламка	реклама
репейничек	репейник
ресничка	ресница
Риточка	Рита
розочка	роза
розеточка	розетка
рыбешка	рыба
рыбина	рыба
рыжеватенький	рыжеватый
рыльце	рыло
рябоватый	рябой
рябенький	рябой
ряшка	ряха
самобраночка	самобранка
вьетнамочка	вьетнамка
гадалочка	гадалка
главненький	главный
глазочек	глазок
гламурненько	гламурно
глупенько	глупо
преглупо	глупо
глуповато	глупо
гнездышко	гнездо
говнище	говно
голубеночек	голубенок
гопничек	гопник
горилочка	горилка
городочек	городок
горшочек	горшок
горяченько	горячо
листик	лист
лифтик	лифт
лихорадочка	лихорадка
личико	лицо
лобик	лоб
лодчонка	лодка
лодочка	лодка
луковичка	луковица
луковка	луковица
луночка	лунка
лучинка	лучина
льготочка	льгота
прелюбезно	любезно
Мадленочка	Мадлена
мазочек	мазок
майонезик	майонез
Максимка	Максим
Максимушка	Максим
малышонок	малыш
малышечка	малышка
Мананочка	Манана
материальчик	материал
машиночка	машинка
медальончик	медальон
медненький	медный
мелконький	мелкий
мелковатый	мелкий
меточка	метка
методичненько	методично
перспективка	перспектива
перспективочка	перспектива
перуаночка	перуанка
перчаточка	перчатка
Петечка	Петя
Петенька	Петя
Петька	Петя
пингвинчик	пингвин
пирушка	пир
письмишко	письмо
письмецо	письмо
плавочки	плавки
планетка	планета
платьишко	платье
платьице	платье
плотоядьненький	плотоядный
повестушка	повесть
поврежденьице	повреждение
сандалик	сандалия
Светланка	Светлана
Светланочка	Светлана
свечкой	свечой
свининка	свинина
свинушка	свинья
свиточек	свиток
связочка	связка
седоватый	седой
седенький	седой
секретуточка	секретутка
серединка	середина
серединочка	середина
середка	середина
середнячок	середняк
сероглазенький	сероглазый
сеструха	сестра
сестренка	сестра
сестреночка	сестра
сестричка	сестра
сестрица	сестра
сигнальчик	сигнал
синенько	сине
синичка	синица
синячок	синяк
сипловато	сипло
сиреневатый	сиреневый
сиреневенький	сиреневый
сисечка	сиська
гостиничка	гостиница
Гошка	Гоша
гравировочка	гравировка
грамотка	грамота
грибок	гриб
грибочек	гриб
гримаска	гримаса
впечатленьице	впечатление
врунишка	врун
всмяточку	всмятку
вспышечка	вспышка
коняга	конь
коник	конь
корешок	корень
костерок	костер
костерочек	костер
костюмчик	костюм
Костенька	Костя
котик	кот
котяра	кот
котище	кот
котелочек	котелок
котеночек	котенок
котлованчик	котлован
коттеджик	коттедж
кофеечек	кофеек
крайненький	крайний
красноглазенький	красноглазый
креативненько	креативно
креслице	кресло
крошечка	крошка
кружечка	кружка
кручинушка	кручина
крысеночек	крысенок
кубичек	кубик
кудлатенький	кудлатый
кудрявенький	кудрявый
кудреватенький	кудрявый
культурка	культура
купидончик	купидон
кургузенький	кургузый
куропаточка	куропатка
курортик	курорт
кустик	куст
кусточек	куст
лавочка	лавка
лавчонка	лавка
лапшичка	лапша
Лизаветочка	Лизавета
паромчик	паром
пассивненько	пассивно
пенечек	пенек
пенек	пень
перегрузочка	перегрузка
перелесочек	перелесок
переломчик	перелом
переменка	перемена
рассужденьице	рассуждение
растворчик	раствор
реечка	рейка
рейсик	рейс
рейтузики	рейтузы
рекогносцировочка	рекогносцировка
ремонтик	ремонт
ретивенько	ретиво
реторточка	реторта
реформочка	реформа
Риммочка	Римма
рифмочка	рифма
родименький	родимый
родничок	родник
ромашечка	ромашка
рубашонка	рубашка
рубашоночка	рубашка
рубашечка	рубашка
рубашка	рубашка
ручища	рука
рученька	рука
ручка	рука
ручонка	рука
рукояточка	рукоятка
рыбалочка	рыбалка
рюмашка	рюмка
рюмашечка	рюмка
рюмочка	рюмка
салатик	салат
салончик	салон
салфеточка	салфетка
газончик	газон
Галиночка	Галина
гарнирчик	гарнир
героинчик	героин
глазастенький	глазастый
глыбочка	глыба
глыбища	глыба
годок	год
годочек	год
годненький	годный
голодновато	голодно
голодноватый	голодный
голодненький	голодный
гоночка	гонка
горка	гора
горушка	гора
горбатенький	горбатый
горюшко	горе
лобочек	лобок
пиздеж	ложь
брехня	ложь
вранье	ложь
лосьончик	лосьон
лоточек	лоток
лупоглазенький	лупоглазый
льдиночка	льдинка
Люба	Любовь
лямочка	лямка
мавзолейчик	мавзолей
маечка	майка
макушечка	макушка
маленечко	мало
манехонько	мало
маловатенько	мало
маленько	мало
малокультурненький	малокультурный
манерочка	манера
марлечка	марля
массовочка	массовка
мачточка	мачта
машинка	машина
медовенький	медовый
мелковато	мелко
меленько	мелко
мелконько	мелко
мерзавочка	мерзавка
месторожденьице	месторождение
мешочек	мешок
мещаночка	мещанка
перстенек	перстень
песочечек	песок
песочек	песок
пестроватый	пестрый
пестренький	пестрый
пещерка	пещера
пианисточка	пианистка
пипеточка	пипетка
плавненький	плавный
пластиночка	пластинка
платформочка	платформа
плашечка	плашка
плащик	плащ
пледик	плед
племяш	племянник
племянничек	племянник
плешивенький	плешивый
плотноватый	плотный
плотненький	плотный
сарайчик	сарай
сборничек	сборник
свадебка	свадьба
светильничек	светильник
свободненько	свободно
седлышко	седло
сезончик	сезон
селяночка	селянка
серовато	серо
серенько	серо
сертификатик	сертификат
Сибиллочка	Сибилла
силушка	сила
силища	сила
силенка	сила
Греточка	Грета
гривенничек	гривенник
грозненький	грозный
грубовато	грубо
грубенько	грубо
грузовичок	грузовик
густенький	густой
густоватый	густой
гуцулочка	гуцулка
давленьице	давление
дворничек	дворник
дворняжка	дворняга
девонька	девочка
девчоночка	девочка
девчонка	девочка
девчушка	девочка
предерзко	дерзко
дерьмовенький	дерьмовый
десантничек	десантник
десяточка	десятка
Димочка	Дима
Димка	Дима
микстурка	микстура
миллионерчик	миллионер
миленький	милый
Митька	Митя
Митенька	Митя
мокренько	мокро
мокрехонько	мокро
мокровато	мокро
молоточек	молоток
мосластенький	мосластый
мудренько	мудро
мулаточка	мулатка
мундштучок	мундштук
мурочка	мурка
мутненько	мутно
мутновато	мутно
мутноватенько	мутно
муфточка	муфта
мышка	мышь
мяконько	мягко
мягенько	мягко
мягонько	мягко
набалдашничек	набалдашник
набоечка	набойка
нагловатый	наглый
подвесочка	подвеска
подготовочка	подготовка
подорожничек	подорожник
подробненько	подробно
подъемчик	подъем
позднехонько	поздно
поздновато	поздно
поздненько	поздно
позднешенько	поздно
поздноватенько	поздно
поколеньице	поколение
сказочка	сказка
сквознячок	сквозняк
скользковатый	скользкий
скребочек	скребок
скромненький	скромный
скромноватый	скромный
скудненький	скудный
скудноватый	скудный
сладковатый	сладкий
сладенький	сладкий
слезнехонько	слезно
слоник	слон
служаночка	служанка
смертничек	смертник
смешноватый	смешной
снарядик	снаряд
снежок	снег
снопик	сноп
собраньице	собрание
совпаденьице	совпадение
солисточка	солистка
сотенка	сотня
длинненький	длинный
длиннехонький	длинный
длинноватый	длинный
довольнехонький	довольный
довольненький	довольный
довольнешенький	довольный
дождевичок	дождевик
дождливенько	дождливо
документик	документ
долговязенький	долговязый
дороговатенький	дороговатый
дочурочка	дочка
дочечка	дочка
драчка	драка
поставочка	драка
дружбочка	дружба
дрянненько	дрянно
дудочка	дудка
Дусечка	Дуся
Дуська	Дуся
душноватый	душный
Егорка	Егор
Егорушка	Егор
единичка	единица
Емелька	Емеля
прежалко	жалко
жалковато	жалко
жалконько	жалко
жалобнехонько	жалобно
железочка	железка
Женька	Женя
Женечка	Женя
Женька	Женя
Женечка	Женя
наклеечка	наклейка
намордничек	намордник
нарядненький	нарядный
наслажденьице	наслаждение
неважненько	неважно
невозможненький	невозможный
неглупенький	неглупый
негодованьице	негодование
покушеньице	покушение
полуподвальчик	полуподвал
помпочка	помпа
помпончик	помпон
понятненько	понятно
попыточка	попытка
посерединке	посередине
посредничек	посредник
стакашечек	стакан
стаканчик	стакан
стакашек	стакан
стандартик	стандарт
стандартненько	стандартно
старшенький	старший
статисточка	статистка
стебелечек	стебель
стебелек	стебель
стервочка	стерва
стервятничек	стервятник
столовка	столовая
стороночка	сторонка
стояночка	стоянка
стразик	страза
странничек	странник
страшненько	страшно
сташноватенько	страшно
страшнехонько	страшно
стрекозочка	стрекоза
строгохонько	строго
строговато	строго
строгонько	строго
стройненько	стройно
стручочек	стручок
супец	суп
супик	суп
супчик	суп
Сусанночка	Сусанна
суставчик	сустав
сутуловато	сутуло
сухарик	сухарь
сытехонько	сыто
Сюзанночка	Сюзанна
табачок	табак
табуреточка	табуретка
тайночка	тайна
танчик	танк
тарелочка	тарелка
вольненько	вольно
вольнехонько	вольно
вприкусочку	вприкуску
вшивенький	вшивый
выраженьице	выражение
корка	кора
коренастенький	коренастый
кореяночка	кореянка
коридорчик	коридор
коробочка	коробка
коробчонка	коробка
корпоративчик	корпоратив
косолапенький	косолапый
косточка	кость
косячок	косяк
котлетка	котлета
котлеточка	котлета
кочанчик	кочан
кошечка	кошка
красновато	красно
кренделек	крендель
креолочка	креолка
крестничек	крестник
Кристинка	Кристина
Кристиночка	Кристина
крохотулечка	крохотуля
кружок	круг
крутоватый	крутой
кудряшечка	кудряшка
кулачище	кулак
кулачишко	кулак
кулачок	кулак
культуристочка	культуристка
курочка	курица
кучечка	кучка
лабрадорчик	Лабрадор
лапочка	лапа
лапища	лапа
лапка	лапа
леечка	лейка
ленточка	лента
лестничка	лестница
лесенка	лестница
лианочка	лиана
линеечка	линейка
парижаночка	парижанка
пейзажисточка	пейзажистка
пенка	пена
переписочка	переписка
расчесочка	расческа
расчудесненько	расчудесно
реактивненько	реактивно
ребятеночек	ребенок
ребеночек	ребенок
ребрышко	ребро
региончик	регион
резвенький	резвый
ремешочек	ремешок
рецептик	рецепт
рододендрончик	рододендрон
розовато	розово
ромбик	ромб
ружьишко	ружье
рябоватенький	рябоватый
рядок	ряд
рядочек	рядок
сабантуйчик	сабантуй
самодельненький	самодельный
вяловато	вяло
вяленько	вяло
газеточка	газета
газетка	газета
газетенка	газета
галочка	галка
галстучек	галстук
гардеробчик	гардероб
геккончик	геккон
гильотинка	гильотина
гимназисточка	гимназистка
голосочек	голосок
голубоглазенький	голубоглазый
голенький	голый
гольфик	гольф
гонорарчик	гонорар
горочка	горка
горстка	горсть
горсточка	горсть
горчичничек	горчичник
ложбинка	ложбина
локоточек	локоток
локоток	локоть
лужок	луг
Луизочка	Луиза
магазинчик	магазин
магнитик	магнит
мажорчик	мажор
Майечка	Майя
Макарушка	Макар
мамочкин	мамин
мамулечка	мамуля
масочка	маска
матросик	матрос
машинисточка	машинистка
персонажик	персонаж
пестроватенький	пестроватый
песчиночка	песчинка
Петруха	Петр
Петруша	Петр
Петька	Петр
пиночек	пинок
пихточка	пихта
плавничок	плавник
платочек	платок
плафончик	плафон
плевенький	плевый
плиточка	плитка
плосконький	плоский
плосковатый	плоский
плотненько	плотно
плюсик	плюс
плюсище	плюс
победочка	победа
поганенький	поганый
самолетик	самолет
самородочек	самородок
санитарочка	санитарка
саночки	санки
сантиметрик	сантиметр
сардинка	сардина
сахарочек	сахарок
сваечка	свая
свечка	свеча
сделочка	сделка
сейфик	сейф
сердцевинка	сердцевина
серебришко	серебро
сестреночка	сестренка
сизовато	сизо
симочка	Сима
сиропчик	сироп
сиротиночка	сиротинка
готовенький	готовый
гребешочек	гребешок
грелочка	грелка
грешок	грех
Гришаня	Гриша
Гришенька	Гриша
Гришка	Гриша
гротик	грот
грубоватый	грубый
грустноватый	грустный
грустненький	грустный
грязноватенький	грязноватый
грязноватый	грязный
далековатый	далекий
дамочка	дама
дачка	дача
двадцатничек	двадцатник
двухтомничек	двухтомник
девчоночка	девчонка
девчушечка	девчушка
делишки	дело
десертик	десерт
детишки	дети
джемперочек	джемпер
Джульетточка	Джульетта
диковинка	диковина
свеколка	свекла
сверхинтересненький	сверхинтересный
свисточек	свисток
свитерочек	свитерок
сводочка	сводка
связисточка	связистка
сгусточек	сгусток
северяночка	северянка
Серафимочка	Серафима
середочка	середка
сиденьице	сиденье
силуэтик	силуэт
симпатичненько	симпатично
синенький	синий
синеватый	синий
сисястенький	сисястый
гостьюшка	гостья
графинчик	графин
гривочка	грива
громковатый	громкий
грудастенький	грудастый
гуляночка	гулянка
давочка	давка
давненько	давно
давнешенько	давно
давнехонько	давно
далековатенько	далековато
дворянчик	дворянин
дедочек	дед
дедушка	дед
дедуля	дед
дедок	дед
дедулька	дед
демократичненько	демократично
деревенька	деревня
деревнюшка	деревня
деревушка	деревня
деревце	дерево
деревянненький	деревянный
дерьмовенько	дерьмово
джинсики	джинсы
джипчик	джип
джипик	джип
Диночка	Дина
Динка	Дина
дипломчик	диплом
Миха	Михаил
модисточка	модистка
молочко	молоко
молчаливенький	молчаливый
мопедик	мопед
мордастенький	мордастый
мордатенький	мордатый
мордашечка	мордашка
морщиночка	морщинка
моторчик	мотор
мотоциклик	мотоцикл
музочка	муза
мундирчик	мундир
мышоночек	мышонок
нагленько	нагло
нагловато	нагло
надежненько	надежно
наживочка	наживка
пограничничек	пограничник
поддержечка	поддержка
подельничек	подельник
подписочка	подписка
подрамничек	подрамник
подсказочка	подсказка
подъездик	подъезд
позвоночек	позвонок
скелетик	скелет
склончик	склон
скуповато	скупо
скупенько	скупо
прескучно	скучно
скучненько	скучно
скучновато	скучно
скучнехонько	скучно
скучноватенько	скучно
слабосильненький	слабосильный
Слава	Славик
слеповато	слепо
словарик	словарь
словечко	слово
слюнка	слюна
смелехонько	смело
смешненько	смешно
смоляночка	смолянка
снеговичок	снеговик
совестишка	совесть
соломинка	соломина
сообщеньице	сообщение
сооруженьице	сооружение
сошка	соха
спиночка	спинка
дисциплинка	дисциплина
дисциплиночка	дисциплина
добродушненько	добродушно
добрячок	добряк
предолго	долго
долговато	долго
долгохонько	долго
достойненький	достойный
дракончик	дракон
дракоша	дракон
дрессировочка	дрессировка
дружненько	дружно
дрябленький	дряблый
дрябловатый	дряблый
дубленочка	дубленка
думочка	дума
думка	дума
душик	душ
дырища	дыра
дырочка	дыра
дырка	дыра
дьячок	дьяк
жорево	еда
жратва	еда
жрачка	еда
ежик	еж
елочка	елка
жакетик	жакет
жалостливенький	жалостливый
желобочек	желобок
женишок	жених
накладочка	накладка
напильничек	напильник
нарядненько	нарядно
нативненько	нативно
наушничек	наушник
неаккуратненько	неаккуратно
полгодика	полгода
полегонечку	полегоньку
преполезно	полезно
полезненько	полезно
Полиночка	Полина
полосатенький	полосатый
полуботиночек	полуботинок
поплавочек	поплавок
порошочек	порошок
портяночка	портянка
постепенненько	постепенно
спозараночку	спозаранку
спокойнехонько	спокойно
спокойнешенько	спокойно
преспокойно	спокойно
спокойненько	спокойно
станочек	станок
престаренький	старый
старенький	старый
староватый	старый
статейка	статья
статеечка	статья
стежечек	стежок
стервозненько	стервозно
стишок	стих
стихотвореньице	стихотворение
столбик	столб
стольничек	стольник
страхованьице	страхование
модненько	модно
монтировочка	монтировка
морковка	морковь
мосточек	мост
муженек	муж
мыслишка	мысль
наводочка	наводка
нагловатенький	нагловатый
наемничек	наемник
наизнаночку	наизнанку
погребок	погреб
подбородочек	подбородок
подрясничек	подрясник
подставочка	подставка
подтяжечка	подтяжка
подходик	подход
скобочка	скобка
прескромненько	скромно
скромненько	скромно
скромнехонько	скромно
скучища	скука
скукотища	скука
скуповатый	скупой
слабоватенько	слабовато
Слава	Славочка
слепочек	слепок
слиточек	слиток
сложновато	сложно
сложноватенько	сложно
сложненько	сложно
смугловатенький	смугловатый
смугляночка	смуглянка
смышлененький	смышленый
собственничек	собственник
соединеньице	соединение
соколик	сокол
солоноватый	соленый
солененький	соленый
сосок	сосочек
состояньице	состояние
Софичка	Софья
сочиненьице	сочинение
сочненький	сочный
спасеньице	спасение
Спирька	Спиридон
списочек	список
договорчик	договор
дождище	дождь
дождичек	дождь
дождик	дождь
докладик	доклад
домишка	дом
домик	дом
домище	дом
домишко	дом
дороговато	дорого
достойненько	достойно
дохловатый	дохлый
дохленький	дохлый
доходик	доход
древненький	древний
дробинка	дробина
дружбан	друг
друган	друг
Дуняшка	Дуня
Дунька	Дуня
Дунечка	Дуня
дурища	дура
дурашка	дура
дурочка	дура
духотища	духота
дымочек	дымок
Евочка	Ева
Женя	Евгения
ежевичка	ежевика
Ефимушка	Ефим
ехидненько	ехидно
желаньице	желание
налетик	налет
нарушеньице	нарушение
наследничек	наследник
наставничек	наставник
наступленьице	наступление
начальничек	начальник
начесик	начес
нашивочка	нашивка
невзрачненько	невзрачно
полезненький	полезный
поленце	полено
полетик	полет
поливалочка	поливалка
половичок	половик
положеньице	положение
полтинничек	полтинник
полуголенький	полуголый
портсигарчик	портсигар
портфельчик	портфель
поршенек	поршень
посланьице	послание
послушненький	послушный
срочненько	срочно
ставочка	ставка
стадиончик	стадион
стеклышко	стекло
стишочек	стишок
столкновеньице	столкновение
сторонничек	сторонник
страничка	страница
странноватенький	странноватый
стрелочка	стрелка
строговатый	строгий
строгонький	строгий
строеньице	строение
стройненький	стройный
стройнехонький	стройный
субъектик	субъект
сумочка	сумка
суммочка	сумма
супермаркетик	супермаркет
сутуленький	сутулый
сутуловатый	сутулый
счастливенько	счастливо
сынишка	сын
сынуля	сын
сыночек	сын
сынок	сын
сыренький	сырой
сыроватый	сырой
сытненько	сытно
Танюшечка	Танюша
Татьяночка	Татьяна
телевизорик	телевизор
теленочек	теленок
телефончик	телефон
аперитивчик	аперитив
аристократочка	аристократка
ароматик	аромат
аспектик	аспект
аукциончик	аукцион
баллончик	баллон
банчик	банк
баночка	банка
Баська	Бася
беззубенький	беззубый
беловатенький	беловатый
запоночка	запонка
заторчик	затор
заумненький	заумный
зачисточка	зачистка
защелочка	защелка
защитничек	защитник
зверюшка	зверь
звереныш	зверь
зверушка	зверь
зверек	зверь
зверюга	зверь
звоночек	звонок
здоровенький	здоровый
злобненько	злобно
значочек	значок
недочетик	недочет
нежненький	нежный
неказистенький	неказистый
некомфортненько	некомфортно
ненасытненький	ненасытный
гримасочка	гримаса
грузик	груз
группка	группа
группочка	группа
грызунчик	грызун
губастенький	губастый
двадцаточка	двадцатка
двоечка	двойка
дедулечка	дедуля
дежурненький	дежурный
декларативненько	декларативно
деликатненько	деликатно
деликатненький	деликатный
дельфинчик	дельфин
дешевенько	дешево
дешевенький	дешевый
Дианочка	Диана
диванчик	диван
дивненько	дивно
дикарочка	дикарка
микрофончик	микрофон
микрочастичка	микрочастица
миниатюрненький	миниатюрный
минусик	минус
Мирандочка	Миранда
мокроватый	мокрый
мокрехонький	мокрый
моментальненько	моментально
монетка	монета
мотылечек	мотылек
мохнатенький	мохнатый
моховичок	моховик
муравейничек	муравейник
подвязочка	подвязка
повязочка	подвязка
подгузничек	подгузник
поддатенький	поддатый
подложечка	подложка
подлокотничек	подлокотник
подосиновичек	подосиновик
подпорочка	подпорка
подросточек	подросток
подсыпочка	подсыпка
подходященько	подходяще
подчисточка	подчистка
поединочек	поединок
покойничек	покойник
скакалочка	скакалка
прескверно	скверно
скверненько	скверно
скидочка	скидка
скрепочка	скрепка
скрипочка	скрипка
скуластенький	скуластый
слабовато	слабо
слабенько	слабо
слабехонько	слабо
славнешенько	славно
славненько	славно
службишка	служба
службочка	служба
смачненько	смачно
собеседничек	собеседник
советничек	советник
соглашеньице	соглашение
соображеньице	соображение
сопливенький	сопливый
сосочек	сосок
состязаньице	состязание
сосудик	сосуд
соточка	сотка
спецовочка	спецовка
довольнехонько	довольно
долечка	доля
долюшка	доля
домашненький	домашний
дороговатенько	дороговато
досочка	доска
досточка	доска
дощечка	доска
дружочек	дружок
дурненький	дурной
дурноватый	дурной
душенька	душа
душонка	душа
дыханьице	дыхание
дюжинка	дюжина
дюночка	дюна
ельничек	ельник
жарковатый	жаркий
жбанчик	жбан
желанненький	желанный
жаланненький	желанный
женка	жена
жинка	жена
женушка	жена
бабский	женский
бабий	женский
накидочка	накидка
накидушка	накидка
негритяночка	негритянка
ползуночек	ползунок
полноватенький	полноватый
половничек	половник
полотенчико	полотенце
полотенчик	полотенце
пользочка	польза
помаленечку	помалу
помаленьку	помалу
помарочка	помарка
пометочка	пометка
помещичек	помещик
попик	поп
поправочка	поправка
попсовенький	попсовый
порожек	порог
порядочек	порядок
поспешненько	поспешно
сподвижничек	сподвижник
спортивненький	спортивный
справочка	справка
средненький	средний
старикашечка	старик
старичок	старик
старикашка	старик
старичочек	старичок
старомодненько	старомодно
стенка	стена
стеночка	стена
стильненько	стильно
стоечка	стойка
столик	стол
стопарик	стопарь
стражничек	стражник
страшноватенько	страшновато
страшноватый	страшный
престрашненький	страшный
страшненький	страшный
стрижечка	стрижка
стружечка	стружка
струйка	струя
струечка	струя
сусличек	Суслик
суходрочка	суходрочка
считалочка	считалка
сюртучок	сюртук
тайничок	тайник
танцулька	танец
театрик	театр
телеканальчик	телеканал
Анюточка	Анюта
аппаратик	аппарат
арбузик	арбуз
арочка	арка
артисточка	артистка
бабуська	бабушка
балетик	балет
барабанчик	барабан
баронессочка	баронесса
басоватый	басовый
батутик	батут
воображеньице	воображение
воротца	ворота
воспитаньице	воспитание
воспоминаньице	воспоминание
восхищеньице	восхищение
впадинка	впадина
вставочка	вставка
втулочка	втулка
коньячок	коньяк
копчененький	копченый
копытце	копыто
коричневатый	коричневый
корочка	корка
коросточка	короста
космонавточка	космонавтка
костылик	костыль
костяшечка	костяшка
кралечка	краля
крантик	кран
краник	кран
кранчик	кран
красивенько	красиво
красочка	краска
красненький	красный
красноватый	красный
красотулечка	красотуля
краюшка	краюха
кровинка	кровь
кровиночка	кровь
кровинушка	кровь
кровища	кровь
кровушка	кровь
крупненько	крупно
крупенько	крупно
крылечко	крыльцо
крышечка	крышка
кубышечка	кубышка
кувшинчик	кувшин
Кузька	Кузя
курятинка	курятина
лазерочек	лазер
лампадочка	лампада
лампадка	лампада
лачужка	лачуга
Левушка	Лев
легендочка	легенда
легохонький	легкий
легенький	легкий
легонький	легкий
легусенький	легкий
легковатый	легкий
леопардик	леопард
лиловатый	лиловый
лиловенький	лиловый
Линдочка	Линда
пароходишко	пароход
пароходик	пароход
препаршиво	паршиво
паршивенько	паршиво
паскудненький	паскудный
патлатенький	патлатый
паутинка	паутина
пацанчик	пацан
пацаненок	пацан
пегасик	Пегас
пейзажик	пейзаж
пенальчик	пенал
первачок	первач
переводик	перевод
перегородочка	перегородка
перекладинка	перекладина
расходик	расход
расценочка	расценка
резиночка	резинка
ремешок	ремень
ресторанчик	ресторан
реченька	речь
родненький	родной
родственничек	родственник
розовенький	розовый
розоватый	розовый
румяненький	румяный
рундучок	рундук
русоволосенький	русоволосый
рыбничек	рыбник
рывочек	рывок
Сабиночка	Сабина
садик	сад
садочек	садок
сайтик	сайт
саквояжик	саквояж
самогончик	самогон
выступленьице	выступление
гадючка	гадюка
газировочка	газировка
галушечка	галушка
гвоздочек	гвоздь
гвоздик	гвоздь
Геночка	Гена
Генка	Гена
гильзочка	гильза
гимнастерочка	гимнастерка
глупышечка	глупышка
гниловатый	гнилой
горбоносенький	горбоносый
горбушечка	горбушка
горелочка	горелка
горошинка	горошина
липковатый	липкий
лисеночек	лисенок
лобастенький	лобастый
ловушечка	ловушка
лопаточка	лопатка
лохотрончик	лохотрон
лужочек	лужок
лучик	луч
Любашечка	Любаша
любовничек	любовник
прелюбопытно	любопытно
Людка	Люда
Людочка	Люда
людишки	люди
лярвочка	лярва
Мальвиночка	Мальвина
манжетка	манжета
маховичок	маховик
махорочка	махорка
медовичок	медовик
мексиканочка	мексиканка
мелочишка	мелочь
мемуарчик	мемуар
мерзенький	мерзкий
мерзенько	мерзко
механизмик	механизм
перестановочка	перестановка
переходик	переход
перчик	перец
перышко	перо
персияночка	персиянка
печальненький	печальный
печеночка	печенка
печеньице	печенье
печенюшка	печенье
пешочком	пешком
пехом	пешком
пивко	пиво
пикапчик	пикап
пикничок	пикник
пилочка	пилка
пилотик	пилот
пилюлька	пилюля
писечка	пися
писька	пися
пиписька	пися
питомничек	питомник
планировочка	планировка
планшетик	планшет
пленочка	пленка
плотвичка	плотва
плюшечка	плюшка
поворотик	поворот
сарделечка	сарделька
Светочка	Света
светлехонько	светло
свирепенький	свирепый
своеобразненько	своеобразно
сдобненький	сдобный
Сережа	Сергей
Сергуня	Сергей
Сергунька	Сергей
Сережка	Сергей
сериальчик	сериал
сероватенько	серовато
сеточка	сетка
сизоватый	сизый
сизенький	сизый
сипловатый	сиплый
греночка	гренка
грешнехонько	грешно
грудка	грудь
грудочка	грудь
группировочка	группировка
густенько	густо
густовато	густо
дамбочка	дамба
дворик	двор
дворяночка	дворянка
Дениска	Денис
дерьмецо	дерьмо
десяточек	десяток
дирижаблик	дирижабль
милостынька	милостыня
мирок	мир
мисочка	миска
мненьице	мнение
могилка	могила
молодочка	молодка
молчаньице	молчание
монголочка	монголка
морщинка	морщина
морячок	моряк
мотивчик	мотив
музейчик	музей
музычка	музыка
муравьишка	муравей
мухоморчик	мухомор
мягковатый	мягкий
мягонький	мягкий
Наденька	Надя
Надюшка	Надя
Надечка	Надя
Надька	Надя
Надюша	Надя
наискосочек	наискосок
поговорочка	поговорка
подарочек	подарок
подловатенький	подловатый
подносик	поднос
поездочка	поездка
скипидарчик	скипидар
сковородка	сковорода
сковородочка	сковородка
скольчик	скол
скоренько	скоро
скорехонько	скоро
скорешенько	скоро
скудненько	скудно
скуднехонько	скудно
скудноватенько	скудно
скудновато	скудно
смазочка	смазка
смазливенький	смазливый
сметанка	сметана
смирненький	смирный
смуглявенький	смуглявый
смущеньице	смущение
Снежаночка	Снежана
снимочек	снимок
собачоночка	собачонка
созданьице	создание
солнышко	солнце
Сонька	Соня
Сонечка	Соня
Сонюшка	Соня
соплеменничек	соплеменник
сопелька	сопля
сопротивленьице	сопротивление
соратничек	соратник
сосисочка	сосиска
сотрудничек	сотрудник
спиралька	спираль
спиртик	спирт
добротненько	добротно
довесочек	довесок
догонялочка	догонялка
драгоценненький	драгоценный
драненький	драный
дробненько	дробно
дробненький	дробный
дровишки	дрова
дубинка	дубина
дубиночка	дубина
дужка	дуга
духовочка	духовка
евреечка	еврейка
едковатый	едкий
енотик	енот
ехидненький	ехидный
Жаклиночка	Жаклин
Жанночка	Жанна
Жасминочка	жасмин
Наночка	Нана
напиточек	напиток
направленьице	направление
нарезочка	нарезка
Наташка	Наташа
Наташенька	Наташа
Наташечка	Наташа
нашлепочка	нашлепка
небрежненько	небрежно
невзрачненький	невзрачный
недоговорочка	недоговорка
полковничек	полковник
полушубочек	полушубок
поляночка	поляна
полянка	поляна
помощничек	помощник
пораженьице	поражение
портретик	портрет
поселочек	поселок
послушненько	послушно
постановочка	постановка
постановленьице	постановление
спортивненько	спортивно
сравненьице	сравнение
сродственничек	сродственник
старушечка	старушка
старушоночка	старушка
статуэточка	статуэтка
стайка	стая
стекляшечка	стекляшка
стеллажик	стеллаж
столечко	столько
страховочка	страховка
стремленьице	стремление
студентик	студент
стульчик	стул
ступенечка	ступенька
судилище	суд
сударушка	сударыня
судьбинушка	судьба
суматошливо	суматошно
схемочка	схема
схемка	схема
сюрпризец	сюрприз
сюрпризик	сюрприз
тактичненько	тактично
Тамарочка	Тамара
тапочка	тапка
твердехонько	твердо
тверденько	твердо
тверденький	твердый
твердоватый	твердый
текстик	текст
телеграммка	телеграмма
арабочка	арабка
Аркашка	Аркаша
Аркашенька	Аркаша
аспиранточка	аспирантка
асфальтик	асфальт
вонища	вонь
времечко	время
вывесочка	вывеска
концовочка	концовка
кораблик	корабль
кофеек	кофе
крабик	краб
краешек	край
красотища	красота
крепенько	крепко
крепконько	крепко
крепковато	крепко
крепонько	крепко
крепостишка	крепость
кривоватый	кривой
кривенький	кривой
кровожадненький	кровожадный
кувалдочка	кувалда
кузиночка	кузина
кулиска	кулиса
куманек	кум
курятничек	курятник
кустарничек	кустарник
кучка	куча
кучненько	кучно
кушеточка	кушетка
Лариска	Лариса
Ларисочка	Лариса
легавенький	легавый
лживенький	лживый
Лилечка	Лиля
паренечек	паренек
парилочка	парилка
паровозик	паровоз
партеечка	партия
партнерчик	партнер
паскудненько	паскудно
препаскудно	паскудно
паяльничек	паяльник
передничек	передник
перекресточек	перекресток
перерывчик	перерыв
рассудочек	рассудок
растеньице	растение
расторопненький	расторопный
расцветочка	расцветка
редисочка	редиска
Ренаточка	Рената
рисуночек	рисунок
робковатый	робкий
рогастенький	рогатый
рогатенький	рогатый
Родька	Родя
розовощекенький	розовощекий
рубашонка	рубаха
рубашка	рубаха
рулетик	рулет
рулеточка	рулетка
рулончик	рулон
Русланчик	Руслан
Руська	Рустам
ручечка	ручка
рыжеватый	рыжий
рыженький	рыжий
садисточка	садистка
саечка	сайка
салажонок	салага
салютик	салют
самогоночка	самогонка
высоконько	высоко
высоковато	высоко
гармошка	гармонь
Генриетточка	Генриетта
гиппопотамчик	гиппопотам
гламурчик	гламур
гламурненький	гламурный
глупенький	глупый
глуповатый	глупый
гнойничок	гнойник
голенастенький	голенастый
башка	голова
головушка	голова
головка	голова
голубенький	голубой
голубоватенький	голубой
голубоватый	голубой
гопачек	гопак
горожаночка	горожанка
горьковатый	горький
горяченький	горячий
листочек	листок
ловконько	ловко
ложечка	ложка
лоскуточек	лоскуток
лубочек	лубок
лучок	лук
лысоватый	лысый
лысенький	лысый
львеночек	львенок
лючок	люк
ляжечка	ляжка
лялечка	Ляля
лялька	Ляля
малинка	малина
малолеточка	малолетка
Мариночка	Марина
Маринка	Марина
марионеточка	марионетка
Маришечка	Мариша
Маришка	Мария
Марьюшка	Мария
Марусенька	Маруся
Маруська	Маруся
Марусечка	Маруся
маршрутик	маршрут
матрасик	матрас
медалька	медаль
мензурочка	мензурка
перетяжечка	перетяжка
переулочек	переулок
перцовочка	перцовка
пеструшечка	пеструшка
печечка	печка
пешечка	пешка
пижамка	пижама
пикантненький	пикантный
пилоточка	пилотка
пирожочек	пирожок
писклявенький	писклявый
питончик	питон
плавненько	плавно
планочка	планка
плетеночка	плетенка
плеточка	плетка
херовый	плохой
фиговый	плохой
плохонький	плохой
хуевый	плохой
плохенький	плохой
плоховатый	плохой
плутишка	плут
повышеньице	повышение
самокруточка	самокрутка
сарафанчик	сарафан
селезеночка	селезенка
семинарчик	семинар
сердитенький	сердитый
сережка	серьга
сивенький	сивый
сигаретка	сигарета
сигареточка	сигарета
ситничек	ситник
гражданочка	гражданка
грустнехонько	грустно
грустновато	грустно
грустненько	грустно
грязища	грязь
Дарьюшка	Дарья
дверка	дверь
дверца	дверь
движочек	движок
двухлеточка	двухлетка
девяточка	девятка
деляночка	делянка
денежка	деньга
деньжонка	деньга
деньжищи	деньга
вооруженьице	вооружение
воробьишка	воробей
воробушек	воробей
воробышек	воробей
вороватенький	вороватый
воскресеньице	воскресенье
встрясочка	встряска
бухло	выпивка
копилочка	копилка
коржик	корж
коротюсенький	короткий
коротенький	короткий
коротковатый	короткий
корявенько	коряво
корявенький	корявый
косенько	косо
косовато	косо
котельчик	котел
кошелечек	кошелек
кошмарненький	кошмарный
крапинка	крапина
кратенько	кратко
краюшечка	краюшка
креветочка	креветка
кристаллик	кристалл
кроваточка	кроватка
крокодильчик	крокодил
кружочек	кружок
крылатенький	крылатый
крылышко	крыло
кулончик	кулон
культурненький	культурный
курточка	куртка
куценько	куце
ладонюшка	ладонь
ладошка	ладонь
ларчик	ларец
лейтенантик	лейтенант
Ленечка	Леня
Ленька	Леня
лепесточек	лепесток
лепешечка	лепешка
линзочка	линза
параллельненько	параллельно
парашютик	парашют
паричок	парик
паршивенький	паршивый
певичка	певица
пидарас	педераст
переборочка	переборка
перевалочка	перевалка
передачка	передача
передозировочка	передозировка
перепелочка	перепелка
растяжечка	растяжка
Раечка	Рая
Региночка	Регина
реденький	редкий
редковатый	редкий
речка	река
речонка	река
речушка	река
рекордик	рекорд
репортажик	репортаж
ресурсик	ресурс
референточка	референтка
ржавенький	ржавый
ридикюльчик	ридикюль
ровненько	ровно
ровнешенько	ровно
ровнехонько	ровно
рожденьице	рождение
романтичненько	романтично
росиночка	росинка
рубаночек	рубанок
рубинчик	рубин
рукавичка	рукавица
рыночек	рынок
рядышком	рядом
сабелька	сабля
салатовенький	салатовый
самочка	самка
самоварчик	самовар
вязковатый	вязкий
гагарочка	гагара
гаденький	гадкий
гаечка	гайка
галерейка	галерея
гарнитурчик	гарнитур
гвоздичка	гвоздика
гектарчик	гектар
гирька	гиря
гладехонько	гладко
гладенько	гладко
глазище	глаз
глазик	глаз
глазищи	глаз
Глафирочка	Глафира
Глебушка	Глеб
глуховатый	глухой
гнильца	гниль
гномик	гном
говядинка	говядина
головастенький	головастый
голосище	голос
голосок	голос
голосочек	голос
горденький	гордый
литрик	литр
лодыжечка	лодыжка
Лолиточка	Лолита
лопоухонький	лопоухий
лохматенький	лохматый
лошаденка	лошадь
лошадочка	лошадь
лошадка	лошадь
лощинка	лощина
лысинка	лысина
любопытненький	любопытный
людоедочка	людоедка
Люсечка	Люся
Люсенька	Люся
лягушонок	лягушка
лягушоночек	лягушонок
майорчик	майор
маловатый	малый
Маргариточка	Маргарита
Марфушка	Марфа
массажик	массаж
Матильдочка	Матильда
Машутка	Маша
Машенька	Маша
Машка	Маша
мертвехонько	мертвенно
мертвехонький	мертвый
мертвенький	мертвый
месячишко	месяц
месяцок	месяц
месяцочек	месяц
мизинчик	мизинец
перестраховочка	перестраховка
перестрелочка	перестрелка
песенка	песня
петличка	петлица
петушок	петух
петушочек	петух
питаньице	питание
пичужка	пичуга
пиявочка	пиявка
плошечка	плошка
плутовочка	плутовка
плюгавенько	плюгаво
повязочка	повязка
Сарочка	Сара
сахарок	сахар
сборочка	сборка
свежатинка	свежатина
сверточек	сверток
свечечка	свечка
свиданьице	свидание
свитерок	свитер
своеобразненький	своеобразный
сдачка	сдача
секретик	секрет
секундочка	секунда
селеньице	селение
сержантик	сержант
деревяшечка	деревяшка
державочка	держава
дерзковатый	дерзкий
деталька	деталь
деталюшка	деталь
милашечка	милашка
мент	милиционер
мирненько	мирно
младенчик	младенец
многовато	много
премного	много
моделька	модель
молоденький	молодой
мордашка	морда
мордочка	морда
морковочка	морковка
моточек	моток
мотылек	мотыль
мрачненький	мрачный
мрачноватый	мрачный
мужичонка	мужик
мужичок	мужик
мужчинка	мужчина
мушка	муха
мятежничек	мятежник
наблюденьице	наблюдение
наборчик	набор
набросочек	набросок
наивненький	наивный
наказаньице	наказание
подборочка	подборка
подвальчик	подвал
подловатый	подлый
подленький	подлый
подстановочка	подстановка
подъемничек	подъемник
позитивненько	позитивно
скамеечка	скамейка
скатик	скат
скверик	сквер
скверчик	сквер
складик	склад
складочка	складка
складненький	складный
сколечко	сколько
скорпиончик	скорпион
скоренький	скорый
скучноватый	скучный
скучненький	скучный
славненький	славный
следочек	следок
слезинка	слеза
слезиночка	слеза
слойчик	слой
снеточек	снеток
соборчик	собор
совочек	совок
солдатик	солдат
солдатушка	солдат
соловушка	соловей
солярочка	солярка
сопелочка	сопелка
сосенка	сосна
сосеночка	сосна
спаленка	спальня
спектаклик	спектакль
спеленький	спелый
спинка	спина
спичечка	спичка
длинненько	длинно
предлинно	длинно
длинновато	длинно
донышко	дно
донце	дно
добренький	добрый
долгоносенький	долгоносый
должничек	должник
долларик	доллар
допросик	допрос
дороговатый	дорогой
предостаточно	достаточно
достиженьице	достижение
дохленько	дохло
дочурка	дочь
дочушка	дочь
дочурочка	дочь
дочечка	дочь
доченька	дочь
дочка	дочь
дружинничек	дружинник
дружненький	дружный
душистенький	душистый
душновато	душно
дымок	дым
дымочек	дым
дырочка	дырка
дядюшка	дядя
дяденька	дядя
дядечка	дядя
дядька	дядя
египтяночка	египтянка
Екатериночка	Екатерина
Еленочка	Елена
фигня	ерунда
херня	ерунда
Фрося	Ефросинья
жавороночек	жаворонок
жаждочка	жажда
прежарко	жарко
жарконько	жарко
желобок	желоб
наколочка	наколка
наливочка	наливка
наметочка	наметка
нападеньице	нападение
напарничек	напарник
насмешечка	насмешка
настырненький	настырный
натуральненько	натурально
невесточка	невеста
невестушка	невеста
покупочка	покупка
полненький	полный
полноватый	полный
полоска	полоса
полосочка	полоса
полупьяненький	полупьяный
помещеньице	помещение
помидорчик	помидор
понедельничек	понедельник
поросеночек	поросенок
поселеньице	поселение
спокойненький	спокойный
сраженьице	сражение
средненько	средне
старушка	старуха
старушенция	старуха
старушонка	старуха
стеклянненький	стеклянный
стенографисточка	стенографистка
Степочка	Степан
Степанушка	Степан
Стенька	Степан
стерженек	стержень
стильненький	стильный
стопочка	стопка
странноватенько	странновато
страстишка	страсть
стрелка	стрела
структурка	структура
стукачок	стукач
стюардессочка	стюардесса
сухощавенький	сухощавый
счетик	счет
сырничек	сырник
сюжетик	сюжет
сюжетец	сюжет
талончик	талон
творожничек	творожник
тележурналисточка	тележурналистка
телефонисточка	телефонистка
Антуанетточка	Антуанетта
Анфисочка	Анфиса
Анька	Аня
Анечка	Аня
атмосферка	атмосфера
серьезненько	серьезно
сигарка	сигара
сиротинушка	сирота
системка	система
системочка	система
гостинчик	гостинец
гранатка	граната
гроздочка	гроздь
грубияночка	грубиянка
групповушка	групповуха
грядочка	грядка
прегрязно	грязно
грязноватенько	грязно
грязновато	грязно
грязьненько	грязно
грязненько	грязно
гувернанточка	гувернантка
гусеничка	гусеница
Данилушка	Данила
Данилка	Данила
двустволочка	двустволка
предерзостно	дерзостно
детективчик	детектив
диковато	дико
предико	дико
диктофончик	диктофон
минералочка	минералка
минутка	минута
минуточка	минута
минуточка	минутка
Мишаня	Миша
Мишенька	Миша
Мишка	Миша
мобильничек	мобильник
молитвенничек	молитвенник
молодехонько	молодо
мониторчик	монитор
морозик	мороз
мортирка	мортира
мочалочка	мочалка
мрачноватенько	мрачно
мрачненько	мрачно
мрачновато	мрачно
муниципалитетик	муниципалитет
мутноватенький	мутноватый
мыльце	мыло
мясцо	мясо
мяско	мясо
наградочка	награда
нагрудничек	нагрудник
назначеньице	назначение
погремушечка	погремушка
поддончик	поддон
поделочка	поделка
подкладочка	подкладка
подловато	подло
подленько	подло
подозреньице	подозрение
подразделеньице	подразделение
подстраховочка	подстраховка
подтвержденьице	подтверждение
поздноватый	поздний
позитивчик	позитив
поклончик	поклон
скандальчик	скандал
скверноватый	скверный
скверненький	скверный
складненько	складно
слабоватый	слабый
слабенький	слабый
слабехонький	слабый
слезиночка	слезинка
слепенький	слепой
слеповатый	слепой
подслеповатый	слепой
слоненочек	слоненок
смартфончик	смартфон
смешочек	смешок
смирнехонько	смирно
смирехонько	смирно
смирненько	смирно
смирнешенько	смирно
смиренненько	смирно
смоквочка	смоква
смутненько	смутно
снежочек	снежок
сниженьице	снижение
сносненько	сносно
собачка	собака
собачонка	собака
содержаньице	содержание
сокращеньице	сокращение
соляночка	солянка
сомик	сом
соперничек	соперник
сопочка	сопка
соревнованьице	соревнование
сориночка	соринка
соседочка	соседка
составчик	состав
спальничек	спальник
деточка	дите
длинноватенький	длинноватый
длинноволосенький	длинноволосый
длинноносенький	длинноносый
дневничок	дневник
догадочка	догадка
дождичек	дождик
долговатый	долгий
долгонький	долгий
дороженька	дорога
дорожка	дорога
досадненький	досадный
доярочка	доярка
драндулетик	драндулет
дрянненький	дрянной
дубок	дуб
дубочек	дуб
дубоватый	дубовый
дурачок	дурак
духовненько	духовно
душевненько	душевно
дырявенький	дырявый
жадноватый	жадный
жадненький	жадный
железненький	железный
желтоватенький	желтоватый
желточек	желток
желтенький	желтый
желтоватый	желтый
жемчужинка	жемчужина
накладненько	накладно
наперсточек	наперсток
напоследочек	напоследок
напряженьице	напряжение
народец	народ
народишко	народ
населеньице	население
Настюша	Настя
Настенька	Настя
невеселенький	невеселый
невинненький	невинный
негативненько	негативно
недешевенький	недешевый
половиночка	половина
половинка	половина
половиночка	половинка
порученьице	поручение
порывчик	порыв
посадочка	посадка
поселяночка	поселянка
последненький	последний
пособничек	пособник
сраненький	сраный
староватенький	староватый
странненько	странно
странновато	странно
вопросец	вопрос
вопросик	вопрос
воротничек	воротник
восстановленьице	восстановление
вредненький	вредный
втихомолочку	втихомолку
выписочка	выписка
выправочка	выправка
выпускничок	выпускник
вырезочка	вырезка
корзиночка	корзина
корзинка	корзина
корнишончик	корнишон
корпусочек	корпус
корреспонденточка	корреспондентка
корытце	корыто
косица	коса
косичка	коса
косматенький	косматый
косенький	косой
косоватый	косой
косорыленький	косорылый
кофейничек	кофейник
кочечка	кочка
кошмарик	кошмар
кошмарчик	кошмар
красноносенький	красноносый
кривовато	криво
кривоватенько	криво
кривенько	криво
кривобокенький	кривобокий
кривоватенький	кривоватый
кроватка	кровать
кромочка	кромка
крупиночка	крупинка
крупненький	крупный
крупноватый	крупный
кукушечка	кукушка
кулечек	кулек
культяпочка	культяпка
купончик	купон
курвочка	курва
курсисточка	курсистка
кусочек	кусок
лаборанточка	лаборантка
ладненький	ладный
лазеечка	лазейка
ласковенько	ласково
лгунишка	лгун
лежаночка	лежанка
лемурчик	лемур
Ленка	Лена
Леночка	Лена
ленивенько	лениво
ленивенький	ленивый
лесбияночка	лесбиянка
либеральненько	либерально
ликерчик	ликер
партизаночка	партизанка
патрончик	патрон
паучок	паук
пацаночка	пацанка
педалька	педаль
пейзажненько	пейзажно
пельмешек	пельмень
первоклашка	первоклассник
перепоночка	перепонка
расстояньице	расстояние
расчисточка	расчистка
револьверчик	револьвер
редехонько	редко
реденько	редко
речечка	речка
ровесничек	ровесник
рожица	рожа
рокировочка	рокировка
ростик	рост
рояльчик	рояль
русалочка	русалка
русенький	русый
рычажок	рычаг
высоконький	высокий
высоковатый	высокий
вьюночек	вьюнок
вязаночка	вязанка
вяловатый	вялый
вяленький	вялый
прегадко	гадко
гаденько	гадко
Гертрудочка	Гертруда
гладенький	гладкий
гнусненько	гнусно
голосованьице	голосование
горденько	гордо
горлышко	горло
листовочка	листовка
логичненько	логично
локальненький	локальный
ломик	лом
лоханочка	лоханка
лукавенький	лукавый
лысоватенький	лысоватый
Магдалиночка	Магдалина
мальчишечка	мальчик
мальчишка	мальчик
мальчонка	мальчик
мамашечка	мамаша
маникюрчик	маникюр
Марианночка	Марианна
марочка	марка
мартышечка	мартышка
Марьяночка	Марьяна
маскировочка	маскировка
матушка	мать
мамка	мать
маятничек	маятник
медок	мед
медвежоночек	медвежонок
мерзавчик	мерзавец
перспективненький	перспективный
песик	пес
печалька	печаль
пиздатенький	пиздатый
пирамидка	пирамида
пиратик	пират
плакатик	плакат
плодик	плод
плоховатенько	плохо
плохонько	плохо
преплохо	плохо
плохенько	плохо
плоховато	плохо
площадка	площадка
площадочка	площадка
пляжик	пляж
повозочка	повозка
поганенько	погано
Санечка	Саня
Санька	Саня
Сашок	Саша
Сашка	Саша
Сашенька	Саша
свалочка	свалка
свеженький	свежий
свежохонький	свежий
светленький	светлый
светловатый	светлый
селедочка	селедка
семерочка	семерка
Сенька	Сеня
Сереженька	Сережа
сероватый	серый
серенький	серый
сильненький	сильный
синеглазенький	синеглазый
готичненько	готично
графичек	график
гривастенький	гривастый
гробик	гроб
грошик	грош
грузноватый	грузный
грядка	гряда
гудочек	гудок
далеконько	далеко
далехонько	далеко
далековато	далеко
далеченько	далеко
Дашечка	Даша
Дашка	Даша
Дашенька	Даша
дверочка	дверка
дебиловатый	дебильный
девка	девушка
денечек	день
денек	день
дефицитик	дефицит
диковатый	дикий
миллиардик	миллиард
миллиончик	миллион
миленько	мило
милосердненький	милосердный
младшенький	младший
многоватенько	многовато
молитвочка	молитва
моржик	морж
мошенничек	мошенник
музыкантик	музыкант
мутантик	мутант
мутненький	мутный
мутноватый	мутный
мышленьице	мышление
наглядненько	наглядно
нагрузочка	нагрузка
надеждочка	надежда
названьице	название
погодка	погода
погончик	погон
подковырочка	подковырка
подловатенько	подловато
подляночка	подлянка
подоконничек	подоконник
подруженька	подруга
подружка	подруга
подснежничек	подснежник
подстилочка	подстилка
подушечка	подушка
поздравленьице	поздравление
показаньице	показание
поклонничек	поклонник
скляночка	склянка
скорлупка	скорлупа
скороговорочка	скороговорка
скотинка	скотина
скульптурка	скульптура
слабинка	слабина
славяночка	славянка
сладковато	сладко
сладенько	сладко
сладехонько	сладко
сладешенько	сладко
слащавенький	слащавый
следок	след
сложноватый	сложный
случайненько	случайно
смугловатый	смуглый
смугленький	смуглый
снегурочка	снегурка
снежиночка	снежинка
собачечка	собачка
собутыльничек	собутыльник
совещаньице	совещание
соломка	солома
сомненьице	сомнение
сообщничек	сообщник
сопровожденьице	сопровождение
соседушка	сосед
союзничек	союзник
добавочка	добавка
должок	долг
дорогушечка	дорогуша
дородненький	дородный
доставочка	доставка
дряхленький	дряхлый
дряхловатый	дряхлый
Женя	Евгений
еврейчик	еврей
едконько	едко
Емеля	Емельян
жабочка	жаба
жалковатый	жалкий
жгутик	жгут
желудочек	желудок
напряжненько	напряжно
нарукавничек	нарукавник
нарядик	наряд
настоечка	настойка
настроеньице	настроение
нахальненько	нахально
нахлебничек	нахлебник
находочка	находка
покорненько	покорно
полочка	полка
полнешенько	полно
полнехонько	полно
помоечка	помойка
понемножку	понемногу
понемножечку	понемногу
понятьице	понятие
попочка	попа
попка	попа
порнушка	порнуха
поставочка	поставка
спутничек	спутник
ссылочка	ссылка
стамесочка	стамеска
Стаська	Стас
Стасик	Стас
Стеллочка	стелла
стеночка	стенка
сторонушка	сторона
сторонка	сторона
страданьице	страдание
страшноватенький	страшноватый
струночка	струнка
стыдненько	стыдно
стыднехонько	стыдно
стыдновато	стыдно
стыдобища	стыдоба
сувенирчик	сувенир
сумасшедшенький	сумасшедший
суховатый	сухой
сухонький	сухой
сценочка	сцена
сценка	сцена
сыренько	сыро
сыровато	сыро
сытенький	сытый
табличка	таблица
Танька	Таня
Танюха	Таня
Танюша	Таня
Танечка	Таня
Танюшка	Таня
тачечка	тачка
арендочка	аренда
Артурчик	Артур
астраханочка	астраханка
аэропортик	аэропорт
багажничек	багажник
баечка	байка
балериночка	балерина
балеринка	балерина
батончик	батон
белесовато	белесо
Беллочка	Белла
белокуренький	белокурый
запретненький	запретный
зарисовочка	зарисовка
застежечка	застежка
затылочек	затылок
захудаленький	захудалый
зацепочка	зацепка
зашарпаненько	зашарпано
звездочка	звезда
землица	земля
земелька	земля
земляночка	землянка
знатненький	знатный
золотистенький	золотистый
страшилочка	страшилка
строчка	строка
строчечка	строчка
струнка	струна
субботочка	суббота
сумбурненько	сумбурно
суховато	сухо
сухонько	сухо
сучочек	сучок
схваточка	схватка
табакерочка	табакерка
тазик	таз
талантище	талант
талантик	талант
талисманчик	талисман
тарталеточка	тарталетка
Антоша	Антон
Антошка	Антон
апельсинчик	апельсин
аргументик	аргумент
архивчик	архив
ассистенточка	ассистентка
аэродромчик	аэродром
бабулька	бабуля
бабуленька	бабуля
бабулечка	бабуля
балаганчик	балаган
бантик	бант
барчик	бар
бедняжечка	бедняга
безумненький	безумный
белесоватенький	белесоватый
беленький	белый
беловатый	белый
записочка	записка
заповедничек	заповедник
зарубочка	зарубка
Зорька	заря
заставочка	заставка
званьице	звание
землетрясеньице	землетрясение
землячок	земляк
земляничка	земляника
зимушка	зима
презло	зло
злючка	злюка
значок	знак
знаньице	знание
зубище	зуб
зубик	зуб
зубчик	зуб
зятек	зять
ивушка	ива
избенка	изба
избушка	изба
непонятненько	непонятно
непослушненький	непослушный
пренепременно	непременно
неспортивненький	неспортивный
нехиленький	нехилый
Никитка	Никита
Никитушка	Никита
никудышненький	никудышный
нимфоманочка	нимфоманка
поступочек	поступок
потенциальчик	потенциал
поточек	поток
пошленько	пошло
пошловатенько	пошло
пошловато	пошло
превеселенький	превеселый
прелестненький	прелестный
пресненький	пресный
пресноватый	пресный
преступничек	преступник
пригорочек	пригорок
телятинка	телятина
темнехонько	темно
темнешенько	темно
темновато	темно
темненько	темно
темноватый	темный
темненький	темный
терактик	теракт
терпеньице	терпение
Тимошка	Тимофей
Тимоша	Тимофей
Тимоха	Тимофей
типчик	тип
титечка	титька
потихонечку	тихо
потихоньку	тихо
товарец	товар
Толенька	Толя
Толька	Толя
Толечка	Толя
Тонечка	Тоня
Тоничка	Тоня
топоточек	топот
топоток	топот
тощенький	тощий
тощеватый	тощий
тростиночка	тростинка
тряпочка	тряпка
туалетик	туалет
туземочка	туземка
тускловатенький	тускловатый
туфелька	туфля
тухленький	тухлый
тухловатый	тухлый
тухлятинка	тухлятина
тучка	туча
тюленьчик	тюлень
тяжковато	тяжко
убогонько	убого
увлеченьице	увлечение
угольничек	угольник
удаленький	удалый
удобненько	удобно
Агнессочка	Агнесса
аджичка	аджика
Алисочка	Алиса
альбомчик	альбом
амазоночка	амазонка
амбарчик	амбар
амулетик	амулет
журнальчик	журнал
заварочка	заварка
завещаньице	завещание
завитушечка	завитушка
загадочка	загадка
загородочка	загородка
заданьице	задание
задержаньице	задержание
займище	займ
заковырочка	заковырка
заколочка	заколка
законопроектик	законопроект
заливчик	залив
новиночка	новинка
новехонький	новый
новешенький	новый
новенький	новый
нолик	ноль
обзорчик	обзор
обморочек	обморок
обмылочек	обмылок
ободочек	ободок
оборотик	оборот
обрывочек	обрывок
обтяжечка	обтяжка
приличненько	прилично
приманочка	приманка
примерчик	пример
принцессочка	принцесса
приоритетик	приоритет
прислужничек	прислужник
приступочка	приступка
проводничка	проводница
продолженьице	продолжение
промашечка	промашка
ужасненько	ужасно
ужасненький	ужасный
ужимочка	ужимка
уздечка	узда
узкоглазенький	узкоглазый
татарочка	татарка
тележка	телега
телеграфисточка	телеграфистка
аппетитненький	аппетитный
Ариночка	Арина
аристократишка	аристократ
армяночка	армянка
Артемушка	Артем
артемчик	Артем
аскетичненько	аскетично
аспиринчик	аспирин
аутентичненько	аутентично
базарчик	базар
балалаечка	балалайка
балкончик	балкон
балычок	балык
бандюга	бандит
бандюган	бандит
бандюк	бандит
барханчик	бархан
батальончик	батальон
батянька	батя
батенька	батя
батька	батя
батюшка	батя
бедрышко	бедро
безволосенький	безволосый
белесенький	белесый
белесоватый	белесый
бензинчик	бензин
зарядик	заряд
зарядочка	зарядка
защитка	защита
заявленьице	заявление
здоровячок	здоровяк
зелененький	зеленый
зеленоватый	зеленый
зернышко	зерно
злорадненький	злорадный
змейка	змея
змеюка	змея
золотишко	золото
золотце	золото
зонтичек	зонтик
зубастенький	зубастый
зубочисточка	зубочистка
Ванечка	Иван
Иванушка	Иван
Ивашка	Иван
Ванюша	Иван
иголочка	иголка
игривенький	игривый
игрушечка	игрушка
идеальчик	идеал
избранничек	избранник
незаметненько	незаметно
некультурненько	некультурно
Нелька	Неля
немчик	немец
необходименький	необходимый
неприметненько	неприметно
непринужденненько	непринужденно
нестыковочка	нестыковка
неудобненько	неудобно
похабненький	похабный
походочка	походка
прадедушка	прадед
прегаденький	прегадкий
прекрасненько	прекрасно
прелестненько	прелестно
препаратик	препарат
препоганенький	препоганый
пресненько	пресно
пресноватенько	пресно
приговорчик	приговор
признаньице	признание
прилавочек	прилавок
темпик	темп
темечко	темя
тенорочек	тенор
терпковатый	терпкий
тетрадочка	тетрадь
тетрадка	тетрадь
толпища	толпа
томик	том
претонюсенький	тонкий
претоненький	тонкий
тоненький	тонкий
тонюсенький	тонкий
тонковатый	тонкий
точечка	точка
траншейка	траншея
трехдюймовочка	трехдюймовка
трошечки	трошки
троячок	трояк
трупик	труп
тумблерочек	тумблер
турчаночка	турчанка
тускловато	тускло
тускленько	тускло
тюбетеечка	тюбетейка
увеличеньице	увеличение
удавочка	удавка
азиаточка	азиатка
Аидочка	Аида
актеришка	актер
американочка	американка
Андрейка	Андрей
Андрюха	Андрей
антилопка	антилопа
жердочка	жердь
жертвочка	жертва
жестконько	жестко
жестковато	жестко
жестяночка	жестянка
жидовочка	жидовка
жилетик	жилет
жилеточка	жилетка
жопастенький	жопастый
заведеньице	заведение
загашничек	загашник
заголовочек	заголовок
загончик	загон
задок	зад
задастенький	задастый
заклинаньице	заклинание
занавесочка	занавеска
занятьице	занятие
норушка	нора
нудненький	нудный
нудноватый	нудный
Нюрочка	Нюра
образочек	образок
обрезочек	обрезок
обуточка	обутка
общинка	община
объятьице	объятие
овсяночка	овсянка
примитивненько	примитивно
пристеночек	пристенок
причесочка	прическа
приятненько	приятно
проблемочка	проблема
проблемка	проблема
провинциалочка	провинциалка
прогнозик	прогноз
прогулочка	прогулка
продуктик	продукт
прожилочка	прожилка
прозрачненький	прозрачный
ужик	уж
указочка	указка
улиточка	улитка
упоминаньице	упоминание
условненько	условно
усмешечка	усмешка
уточка	утка
мгновеньице	участие
участочек	участок
учебничек	учебник
ученичок	ученик
ушастенький	ушастый
фальшивенький	фальшивый
странненький	странный
странноватый	странный
стремненько	стремно
стремновато	стремно
студенточка	студентка
стыдливенько	стыдливо
сугробик	сугроб
сучка	сука
сундучок	сундук
сушечка	сушка
сферочка	сфера
съемочка	съемка
сыночек	сынок
таблеточка	таблетка
тайфунчик	тайфун
такусенький	такой
таракашка	таракан
тараканчик	таракан
тараканище	таракан
тарифчик	тариф
татуировочка	татуировка
архетипичненько	архетипично
архитектурка	архитектура
бабеночка	бабенка
багетик	багет
багульничек	багульник
банальненько	банально
барахлишко	барахло
барьерчик	барьер
бассейнчик	бассейн
бассейник	бассейн
бедняжечка	бедняжка
безделушечка	безделушка
белоголовенький	белоголовый
заправочка	заправка
запущененько	запущено
затейка	затея
заумненько	заумно
зайка	заяц
зайчик	заяц
зайчишка	заяц
зайчище	заяц
заинька	заяц
Зиночка	Зина
Зинуля	Зина
Зинка	Зина
зрачечек	зрачок
зреньице	зрение
Изабеллочка	Изабелла
недурненько	недурно
незаметненький	незаметный
немножко	немного
немножечко	немного
непростенький	непростой
нехорошенький	нехороший
Николашка	Николай
Николенька	Николай
поступленьице	поступление
посудка	посуда
потаскушка	потаскуха
потасовочка	потасовка
предупрежденьице	предупреждение
преподленько	преподло
прибавочка	прибавка
призначек	признак
приказаньице	приказание
тельняшечка	тельняшка
темнотища	темнота
тесноватенько	тесновато
тихонечко	тихонько
толстоморденький	толстомордый
толстячок	толстяк
топорик	топор
топчанчик	топчан
травка	трава
травушка	трава
трамвайчик	трамвай
троечка	тройка
тропиночка	тропинка
трошки	трохи
туговато	туго
тупичок	тупик
тупоморденький	тупомордый
тупорыленький	тупорылый
турнирчик	турнир
тщедушненький	тщедушный
тысчонка	тысяча
тяжеленько	тяжело
тяжелехонько	тяжело
тяжелешенько	тяжело
тяжеловато	тяжело
тяжеловатенько	тяжеловато
уголок	угол
уголовничек	уголовник
удивленьице	удивление
Авдотьюшка	Авдотья
автомобильчик	автомобиль
аккуратненький	аккуратный
активчик	актив
актуальненько	актуально
акцентик	акцент
алмазик	алмаз
ангелок	ангел
ангелочек	ангел
Ангелиночка	Ангелина
Аннушка	Анна
Анночка	Анна
живописненько	живописно
жидочек	жид
жидковатый	жидкий
жиденький	жидкий
жутенький	жуткий
жутковатый	жуткий
жутковатенький	жутковатый
заботушка	забота
завалященький	завалящий
зазнобушка	зазноба
закалочка	закалка
закатик	закат
закорючка	закорюка
закорючечка	закорючка
закусочка	закуска
закуточек	закуток
запашок	запах
номерочек	номерок
носатенький	носатый
носочек	носок
оберточка	обертка
обещаньице	обещание
обильненько	обильно
овражек	овраг
овечка	овца
огарочек	огарок
оговорочка	оговорка
огонечек	огонек
примененьице	применение
примитивненький	примитивный
припадочек	припадок
приписочка	приписка
прицепчик	прицеп
проверочка	проверка
проворненько	проворно
происхожденьице	происхождение
проклятьице	проклятие
проливчик	пролив
узенько	узко
узковато	узко
преузко	узко
укрепленьице	укрепление
укрытьице	укрытие
умишко	ум
умище	ум
умничка	умница
уморушка	умора
упорчик	упор
усадебка	усадьба
уховерточка	уховертка
участничек	участник
фальшивочка	фальшивка
филиальчик	филиал
фифочка	фифа
флигелечек	флигель
бедненький	бедный
бедноватый	бедный
бежевенький	бежевый
заразочка	зараза
заслоночка	заслонка
заступничек	заступник
затравочка	затравка
зелененько	зелено
злорадненько	злорадно
злющенький	злющий
значеньице	значение
Зосечка	Зося
Идочка	Ида
идейка	идея
незадачка	незадача
немочка	немка
ненаглядненький	ненаглядный
необычненько	необычно
пренеприятно	неприятно
неприятненько	неприятно
неприятненький	неприятный
нестабильненько	нестабильно
неустоечка	неустойка
низенький	низкий
низковатый	низкий
никакошенький	никакой
никакусенький	никакой
постненький	постный
построечка	постройка
похабненько	похабно
пошленький	пошлый
пошловатый	пошлый
поясочек	поясок
преаккуратненький	преаккуратный
предбанничек	предбанник
предельчик	предел
предложеньице	предложение
прекрасненький	прекрасный
преспокойненько	преспокойно
преступленьице	преступление
придумочка	придумка
прикосновеньице	прикосновение
приливчик	прилив
телогреечка	телогрейка
тепловатый	теплый
тепленький	теплый
теченьице	течение
толстовочка	толстовка
тонехонько	тонко
тонюсенько	тонко
тоненько	тонко
тонешенько	тонко
торбочка	торба
торгаш	торговец
травничек	травник
трактирчик	трактир
трамплинчик	трамплин
тренажерчик	тренажер
трешечка	трешка
трещинка	трещина
тридцатничек	тридцатник
тропка	тропа
тропинка	тропа
тропочка	тропа
тростинка	тростина
тросточка	трость
трубочка	трубка
трусливенький	трусливый
трусоватый	трусливый
туповатенько	туповато
туповатенький	туповатый
туповатый	тупой
тупенький	тупой
турбинка	турбина
тюряга	тюрьма
убогонький	убогий
удавчик	удав
Агаточка	Агата
агентик	агент
адресочек	адрес
адресок	адрес
Алиночка	Алина
Аллочка	Алла
англичаночка	англичанка
Андрюшка	Андрюша
Андрюшенька	Андрюша
Андрюшечка	Андрюша
жестковатый	жесткий
животик	живот
жиденько	жидко
жидковато	жидко
прежирно	жирно
жирненько	жирно
жирновато	жирно
жирнешенько	жирно
жирненький	жирный
жирноватый	жирный
презабавно	забавно
забавненько	забавно
забастовочка	забастовка
загвоздочка	загвоздка
загореленький	загорелый
заготовочка	заготовка
задачка	задача
закоулочек	закоулок
зальчик	зал
занятненько	занятно
презанятно	занятно
ничуточки	ничуть
ножовочка	ножовка
нормальненько	нормально
носилочки	носилки
нужненький	нужный
нянька	нянька
обидненько	обидно
облегченьице	облегчение
обломочек	обломок
образованьице	образование
обрубочек	обрубок
обстрельчик	обстрел
общежитьице	общежитие
объявленьице	объявление
объясненьице	объяснение
примерочка	примерка
пристойненько	пристойно
проволочка	проволока
проворненький	проворный
прожорливенький	прожорливый
прокуратурка	прокуратура
указаньице	указание
укольчик	укол
украшеньице	украшение
укромненький	укромный
улочка	улица
уныленько	уныло
упаковочка	упаковка
утюжок	утюг
уютненький	уютный
файлик	файл
фиалочка	фиалка
фонтанчик	фонтан
векселечек	вексель
вертлявенький	вертлявый
вершочек	вершок
вечерок	вечер
Виолетточка	Виолетта
Виталька	Виталий
вишенка	вишня
возраженьице	возражение
войнушка	война
волейбольчик	волейбол
измененьице	изменение
изображеньице	изображение
инициативочка	инициатива
инструментик	инструмент
инсценировочка	инсценировка
интенсивненько	интенсивно
искорка	искра
источничек	источник
исчезновеньице	исчезновение
итальяночка	итальянка
казачек	казак
калиночка	калинка
каминчик	камин
огуречик	огурец
огурчик	огурец
одежонка	одежда
одноглазенький	одноглазый
Олечка	Оля
Олька	Оля
Оленька	Оля
ориентировочка	ориентировка
осадочек	осадок
осаночка	осанка
осинка	осина
осторожненький	осторожный
простоватенький	простоватый
просьбочка	просьба
противничек	противник
противненький	противный
процедурненько	процедурно
проявленьице	проявление
псинка	псина
пташечка	пташка
пузырик	пузырь
пулька	пуля
пунктик	пункт
пустоватый	пустой
пустенький	пустой
путевочка	путевка
пухлявенький	пухлявый
пушистенький	пушистый
пушечка	пушка
пчелочка	пчелка
пылиночка	пылинка
равномерненько	равномерно
радиоприемничек	радиоприемник
хамончик	хамон
херовенький	херовый
хитровато	хитро
хитренько	хитро
прехитро	хитро
хищненько	хищно
хористочка	хористка
хорошенечко	хорошо
хорошенько	хорошо
хреновенько	хреново
хреновато	хреново
хуевенько	хуево
хуторок	хутор
цветастенький	цветастый
цилиндрик	цилиндр
циферка	цифра
частушечка	частушка
чахловатый	чахлый
чахленький	чахлый
чемоданчик	чемодан
чердачок	чердак
черемушка	черемуха
черноволосенький	черноволосый
черноглазенький	черноглазый
черноватый	черный
черненький	черный
чертежик	чертеж
чертовочка	чертовка
чертовщинка	чертовщина
чесночок	чеснок
четверочка	четверка
чистенько	чисто
чистехонько	чисто
чистешенько	чисто
чистовичок	чистовик
чистенький	чистый
беспечненько	беспечно
благополучненько	благополучно
благородненький	благородный
блиночек	блин
блинчик	блин
болтик	болт
больненько	больно
больновато	больно
пребольно	больно
большевичок	большевик
брезгливенько	брезгливо
брикетик	брикет
бродяжка	бродяга
брошка	брошь
бубличек	бублик
буроватенький	буроватый
буряточка	бурятка
былиночка	былинка
быстроглазенький	быстроглазый
быстренький	быстрый
вагончик	вагон
вареньице	варенье
капелька	капля
Каролиночка	Каролина
катерок	катер
катерочек	катер
Катеринушка	Катерина
Катериночка	Катерина
катушечка	катушка
Катюшенька	Катюша
Катюшечка	Катюша
кашка	каша
кефирчик	кефир
кипятильничек	кипятильник
Кирюша	Кирилл
Кирюха	Кирилл
Кирюшка	Кирилл
кладочка	кладка
кларочка	Клара
клевенько	клево
клетушка	клетка
клеточка	клетка
клиночек	клинок
клюковка	клюква
коготочек	коготок
коготок	коготок
козочка	коза
кокосик	кокос
коллективчик	коллектив
колосок	колос
колыбелечка	колыбелька
Коленька	Коля
Колюнчик	Коля
Колька	Коля
колясочка	коляска
компрессик	компресс
приоткрытый	открытый
отраженьице	отражение
отстойненько	отстойно
оттяжечка	оттяжка
охранничек	охранник
оценочка	оценка
очаровашечка	очаровашка
очертаньице	очертание
палочка	палка
пальтишко	пальто
пампушечка	пампушка
панталончики	панталоны
папочка	папка
радисточка	радистка
разбойничек	разбойник
разводик	развод
разгрузочка	разгрузка
размерчик	размер
разрядик	разряд
ракеточка	ракетка
раскладушечка	раскладушка
распальцовочка	распальцовка
шейка	шея
шикарненько	шикарно
шинелька	шинель
шнапсик	шнапс
шотландочка	шотландка
шпаргалочка	шпаргалка
шторочка	штора
шторка	штора
шумок	шум
эгоисточка	эгоистка
фигуристочка	фигуристка
фирмочка	фирма
флажочек	флажок
флакончик	флакон
ведьмочка	ведьма
веничек	веник
веселенький	веселый
вещичка	вещь
вещица	вещь
взрывчаточка	взрывчатка
взяточка	взятка
винзаводик	винзавод
винтажненько	винтажно
влажненький	влажный
влажноватый	влажный
внучок	внук
внучоночек	внук
внучек	внук
Вовчик	Вова
водица	вода
водичка	вода
войлочек	войлок
вокзальчик	вокзал
воланчик	волан
волосинка	волосина
изюминка	изюмина
изящненько	изящно
Инночка	Инна
иностраночка	иностранка
интересненький	интересный
интерьерчик	интерьер
интрижка	интрига
инцидентик	инцидент
Иудушка	Иуда
каемочка	каемка
казармочка	казарма
каламбурчик	каламбур
оградка	ограда
однообразненько	однообразно
окантовочка	окантовка
Олежка	Олег
опасеньице	опасение
опасненько	опасно
оперативненький	оперативный
опрятненько	опрятно
орешек	орех
осинничек	осинник
осколочек	осколок
проступочек	проступок
простынка	простыня
простыночка	простыня
процессик	процесс
прощаньице	прощание
прудик	пруд
прудочек	пруд
прудок	пруд
пружинка	пружина
прыжочек	прыжок
пряничек	пряник
пуделек	пудель
пузыречек	пузырек
пулеметик	пулемет
пышненький	пышный
пьянешенький	пьяный
бухой	пьяный
пьяноватый	пьяный
пьянехонький	пьяный
пьяненький	пьяный
пьяноватенький	пьяный
пяточка	пятка
работка	работа
работенка	работа
фразочка	фраза
Фридочка	Фрида
халявненько	халявно
Ханночка	Ханна
херувимчик	херувим
хлебушек	хлеб
хлюпенький	хлюпкий
хохоток	хохот
хохоточек	хохот
храмчик	храм
цепочка	цепь
циновочка	циновка
цыганочка	цыганка
червячок	червяк
червяк	червячок
черепашка	черепаха
четвертиночка	четвертинка
чечеточка	чечетка
чувачок	чувак
чудесненько	чудесно
чудненько	чудно
чумазенький	чумазый
шавочка	шавка
шайбочка	шайба
шаечка	шайка
шатеночка	шатенка
шашечка	шашка
шепоточек	шепоток
шестереночка	шестеренка
шестерочка	шестерка
шестеренка	шестерня
бережненько	бережно
бестолковенький	бестолковый
бидончик	бидон
блаженненький	блаженный
блочок	блок
боженька	бог
бомбочка	бомба
бортик	борт
бочечка	бочка
брошечка	брошка
брюхатенький	брюхатый
буквочка	буква
буковка	буква
буклетик	буклет
булавочка	булавка
бурдючок	бурдюк
буроватый	бурый
буренький	бурый
бухточка	бухта
в обнимочку	в обнимку
вазончик	вазон
валеночек	валенок
валокординчик	валокордин
ванночка	ванна
Василинка	Василина
Василисушка	Василиса
капусточка	капуста
капустка	капуста
карабинчик	карабин
Катенька	Катя
Катька	Катя
Катюшка	Катя
кителечек	китель
кладовочка	кладовка
классненько	классно
клепочка	клепка
книжечка	книга
книжка	книга
кнутик	кнут
кобелек	кобель
ковшик	ковш
ковшичек	ковшик
козлятинка	козлятина
колонисточка	колонистка
кольчужка	кольчуга
командировочка	командировка
комарик	комар
компотик	компот
комфортненько	комфортно
контактик	контакт
отдельчик	отдел
отрезочек	отрезок
отросточек	отросток
отставочка	отставка
охотненько	охотно
пальчик	палец
парочка	пара
парадик	парад
развлеченьице	развлечение
распасовочка	распасовка
распечаточка	распечатка
расписочка	расписка
распрекрасненько	распрекрасно
рассказик	рассказ
расстановочка	расстановка
электрончик	электрон
элитненько	элитно
Эльвирочка	Эльвира
энергичненько	энергично
южок	юг
ярковатый	яркий
ясненько	ясно
яснешенько	ясно
яснехонько	ясно
ясненький	ясный
яснехонький	ясный
яснешенький	ясный
шкатулочка	шкатулка
шматочек	шматок
шнурочек	шнурок
Шурка	Шура
Шурочка	Шура
Шурочка	Шура
шурупчик	шуруп
щепоточка	щепотка
щеточка	щетка
щупленький	щуплый
щупловатый	щуплый
экземплярчик	экземпляр
экзотичненько	экзотично
эзотичненько	экзотично
яблонька	яблоня
ягненочек	ягненок
ядрышко	ядро
янтарчик	янтарь
ястребок	ястреб
ящичек	ящик
неосторожненько	неосторожно
непорядочек	непорядок
неприглядненько	неприглядно
нехуденький	нехудой
низенько	низко
низковато	низко
низехонько	низко
низешенько	низко
походик	поход
поэтессочка	поэтесса
правдочка	правда
праздничек	праздник
представленьице	представление
презреньице	презрение
привальчик	привал
приготовленьице	приготовление
приемничек	приемник
призик	приз
терьерчик	терьер
тесноватенький	тесноватый
тесненький	тесный
тесноватый	тесный
толстожопенький	толстожопый
толстушечка	толстушка
точненько	точно
точнешенько	точно
точнехонько	точно
травмочка	травма
трезвенький	трезвый
трезвехонький	трезвый
тросик	трос
трусики	трусы
туничка	туника
тупоносенький	тупоносый
туристочка	туристка
тухловато	тухло
тухленько	тухло
тушка	туша
тяжеленький	тяжелый
тяжеловатый	тяжелый
тяжелехонький	тяжелый
тяпочка	тяпка
убежденьице	убеждение
убыточек	убыток
уголек	уголь
угрозочка	угроза
ударчик	удар
удачненький	удачный
автоматик	автомат
Адочка	Ада
актик	акт
Алевтиночка	Алевтина
аллейка	аллея
аловатый	алый
аленький	алый
альпинисточка	альпинистка
Аниточка	Анита
жеребчик	жеребец
прежестоко	жестоко
жетончик	жетон
Жозефиночка	Жозефина
Жоржеточка	Жоржетта
заботливенький	заботливый
завязочка	завязка
загрузочка	загрузка
закладочка	закладка
замашечка	замашка
заметненько	заметно
ножичек	нож
ночка	ночь
ноченька	ночь
обследованьице	обследование
объектик	объект
обыкновенненький	обыкновенный
огонек	огонь
присосочка	присоска
приставочка	приставка
пристроечка	пристройка
присыпочка	присыпка
притирочка	притирка
притончик	притон
причальчик	причал
приютик	приют
пробежечка	пробежка
провальчик	провал
проемчик	проем
удостовереньице	удостоверение
узелочек	узелок
уловочка	уловка
Улька	Уля
умильненький	умильный
умненько	умно
умнешенько	умно
умнехонько	умно
ухваточка	ухватка
ушко	ухо
фальшбортик	фальшборт
фартучек	фартук
фасончик	фасон
фельетончик	фельетон
феминисточка	феминистка
Филька	Филя
фитюлечка	фитюлька
фончик	фон
формочка	форма
формированьице	формирование
ведрышко	ведро
ведерко	ведро
великанчик	великан
верстачок	верстак
ветрище	ветер
ветерок	ветер
веточка	ветка
вечериночка	вечеринка
Витюша	Виктор
винтовочка	винтовка
висюлечка	висюлька
вишневенький	вишневый
Вовочка	Владимир
Владька	Владимир
Вова	Владимир
Вован	Владимир
Вовка	Владимир
вмятинка	вмятина
водила	водитель
водочка	водка
водяра	водка
водоворотик	водоворот
возбужденьице	возбуждение
возвращеньице	возвращение
волжаночка	волжанка
волоконце	волокно
Исусик	Иисус
индианочка	индианка
интересик	интерес
ирландочка	ирландка
испаночка	испанка
каблучок	каблук
кавалеристочка	кавалеристка
кадрик	кадр
Оксаночка	Оксана
опасненький	опасный
оперативничек	оперативник
описаньице	описание
оправданьице	оправдание
опросик	опрос
опрятненький	опрятный
ослик	осел
оскорбленьице	оскорбление
остренько	остро
острехонько	остро
островочек	островок
отверточка	отвертка
отвращеньице	отвращение
прорвочка	прорва
проспектик	проспект
прохладненько	прохладно
прохладновато	прохладно
прохладноватый	прохладный
прохладненький	прохладный
пуговичка	пуговица
пупочек	пупок
пурпурненький	пурпурный
путаночка	путана
пышечка	пышка
пьяненько	пьяно
пьянехонько	пьяно
фотончик	фотон
фуражечка	фуражка
халтурка	халтура
хворостиночка	хворостина
хворостинка	хворостина
хероватенько	херовато
хитроватый	хитрый
хитренький	хитрый
хитроватенький	хитрый
хлыстик	хлыст
хоботок	хобот
холмик	холм
хохлушечка	хохлушка
хрипловатый	хриплый
худышечка	худышка
цветочек	цветок
чаек	чай
чаечек	чай
черепочек	черепок
черновичок	черновик
четвертачок	четвертак
четырехугольничек	четырехугольник
членик	член
чумазенько	чумазо
шажочек	шажок
шампуньчик	шампунь
шампусик	шампунь
шапчонка	шапка
шапочка	шапка
шахточка	шахта
шершавенький	шершавый
бесцветненько	бесцветно
бечевочка	бечевка
бледноватенький	бледноватый
блендочка	бленда
блесточка	блестка
блиндажик	блиндаж
богатенько	богато
пребогато	богато
боязливенький	боязливый
бритвочка	бритва
бросочек	бросок
брусничка	брусника
брюшко	брюхо
бугорок	бугор
букетик	букет
булыжничек	булыжник
бульбочка	бульба
бульварчик	бульвар
бумажничек	бумажник
бурунчик	бурун
бусинка	бусина
бутончик	бутон
бюстик	бюст
вазочка	ваза
валерьяночка	валерьянка
канатик	канат
касторочка	касторка
квартальчик	квартал
квиточек	квиток
кисонька	киса
киска	киса
кисловатый	кислый
кисленький	кислый
кисточка	кисть
кишлачок	кишлак
Клавочка	Клава
Клавушка	Клава
клинышек	клин
клювик	клюв
коврик	ковер
коготок	коготь
колышек	кол
колготочки	колготки
коленочка	коленка
колоночка	колонка
комбинезончик	комбинезон
коммунисточка	коммунистка
компактненько	компактно
компашка	компания
комплектик	комплект
компроматик	компромат
комсомолочка	комсомолка
конторка	контора
открыточка	открытка
отставничек	отставник
оттеночек	оттенок
отшельничек	отшельник
официантик	официант
оформленьице	оформление
охапочка	охапка
очерединка	очередь
очередища	очередь
павильончик	павильон
павлинчик	павлин
памятничек	памятник
панелька	панель
панихидка	панихида
папироска	папироса
папиросочка	папироса
радостишка	радость
раздраженьице	раздражение
разработочка	разработка
райончик	район
рамочка	рамка
раскатик	раскат
рассольничек	рассольник
ширмочка	ширма
шкаф	шкаф
шкафчик	шкаф
шлюпчонка	шлюпка
шлюпочка	шлюпка
штампик	штамп
штормик	шторм
штришок	штрих
штучка	штука
штукенция	штука
штуковинка	штуковина
штурвальчик	штурвал
шубка	шуба
шубейка	шуба
шубенка	шуба
шумноватый	шумный
шустренько	шустро
щекастенький	щекастый
эклектичненько	эклектично
экономисточка	экономистка
экстремальненько	экстремально
юбелейчик	юбилей
юбилейчик	юбилей
Юлечка	Юлия
Юленька	Юлия
ящик	ящичек
афишка	афиша
бабонька	баба
бабушка	баба
бабища	баба
бабенка	баба
бабеночка	баба
балочка	балка
бальзамчик	бальзам
бананчик	банан
банька	баня
барашек	баран
бараночка	баранка
бардачок	бардак
басок	бас
бегемотик	бегемот
бедненько	бедно
бедноватенько	бедно
зарплатка	зарплата
затяжечка	затяжка
заявочка	заявка
зданьице	здание
здоровьишко	здоровье
здоровьице	здоровье
зеркальце	зеркало
Зинулечка	Зинуля
нежнехонько	нежно
нежненько	нежно
нездоровенький	нездоровый
некрасивенький	некрасивый
немудрященький	немудрящий
неровненько	неровно
несостыковочка	несостыковка
неспешненько	неспешно
неудачненький	неудачный
ниточка	нитка
постненько	постно
потненький	потный
поцелуйчик	поцелуй
пребыстренько	пребыстро
предметик	предмет
предложеньице	предположение
прекоротенький	прекороткий
премиленько	премило
препротивненько	препротивно
прививочка	прививка
приглашеньице	приглашение
приемчик	прием
призмочка	призма
приключеньице	приключение
температурка	температура
теплехонько	тепло
тепленько	тепло
теплешенько	тепло
террористочка	террористка
тесемочка	тесемка
тестик	тест
тигреночек	тигренок
толстенько	толсто
толстобрюхенький	толстобрюхий
толстозаденький	толстозадый
тополек	тополь
торопыжка	торопыга
тротуарчик	тротуар
труднехонько	трудно
трудновато	трудно
трудненько	трудно
трудноватенько	трудновато
трусишка	трус
туговатенько	туговато
тумбочка	тумба
тусовочка	тусовка
тушеночка	тушенка
угодливенький	угодливый
угодничек	угодник
уголечек	уголек
удачненько	удачно
активисточка	активистка
Аленушка	Алена
Аленка	Алена
Аленочка	Алена
ампулка	ампула
Анджелка	Анджела
Анжелочка	Анжела
Анжелка	Анжела
анонимочка	анонимка
антенночка	антенна
живешенько	живо
живенько	живо
живехонько	живо
живенький	живой
животинка	животина
жидковатенький	жидковатый
жилка	жила
жилочка	жила
забавненький	забавный
заборчик	забор
завершеньице	завершение
заговорчик	заговор
зажигалочка	зажигалка
зазубринка	зазубрина
зайчоночек	зайчонок
заклепочка	заклепка
запасик	запас
запиночка	запинка
новостишка	новость
ноготок	ноготь
нормальненький	нормальный
нудисточка	нудистка
нудненько	нудно
нюансик	нюанс
обеспеченьице	обеспечение
облачко	облако
облицовочка	облицовка
обработочка	обработка
обрывчик	обрыв
обученьице	обучение
обшарпаненько	обшарпанно
обычненько	обычно
обычненький	обычный
овчарочка	овчарка
приличненький	приличный
приобретеньице	приобретение
приторненько	приторно
проектик	проект
прокладочка	прокладка
промежуточек	промежуток
укладочка	укладка
украиночка	украинка
укромненько	укромно
умненький	умный
преумненький	умный
умывальничек	умывальник
ураганчик	ураган
урывочек	урывок
успешненько	успешно
установочка	установка
ухмылочка	ухмылка
фабричка	фабрика
фамильярненько	фамильярно
фашисточка	фашистка
Федюня	Федор
фермочка	ферма
феечка	фея
флейточка	флейта
фондик	фонд
вездеходик	вездеход
венерочка	Венера
веревочка	веревка
вертолетик	вертолет
вертушечка	вертушка
вестибюльчик	вестибюль
взбивалочка	взбивалка
виллочка	вилла
виноградничек	виноградник
височек	висок
вкладик	вклад
превкусно	вкусно
вкусненько	вкусно
вкусненький	вкусный
водоемчик	водоем
упражненьице	упражнение
учрежденьице	учреждение
ушаночка	ушанка
Фаинушка	Фаина
Фаиночка	Фаина
фактик	факт
факультетик	факультет
фиговенький	фиговый
фигурка	фигура
фигурочка	фигура
фитилек	фитиль
беспокойненький	беспокойный
библиотечка	библиотека
битвочка	битва
благополучненький	благополучный
благопристойненько	благопристойно
блевотинка	блевотина
блестященький	блестящий
блокнотик	блокнот
блузочка	блузка
боеприпасик	боеприпас
пребойко	бойко
бордельчик	бордель
бородка	борода
бородища	борода
бороденка	борода
бородатенький	бородатый
босичком	босиком
бравенький	бравый
братан	брат
братушка	брат
браточек	брат
братуха	брат
братишка	брат
братишечка	брат
братик	брат
братец	брат
бревнышко	бревно
бретелечка	бретелька
бриллиантик	бриллиант
броневичок	броневик
брючки	брюки
будильничек	будильник
бутербродик	бутерброд
буханочка	буханка
вагонеточка	вагонетка
вариантик	вариант
введеньице	введение
вдовушка	вдова
Кариночка	Карина
картошечка	картошка
каруселька	карусель
касаточка	касатка
кассетка	кассета
каталочка	каталка
кинжальчик	кинжал
Кирочка	Кира
китаеза	китаец
клееночка	клеенка
клочочек	клочок
клубочек	клубок
клумбочка	клумба
клыкастенький	клыкастый
клятвочка	клятва
кнопочка	кнопка
князек	князь
князюшка	князь
кобылочка	кобыла
ковролинчик	ковролин
кожаночка	кожанка
козленочек	козленок
коечка	койка
кокардочка	кокарда
кокеточка	кокетка
колобочек	колобок
коморочка	коморка
компактненький	компактный
конопатенький	конопатый
откровенненько	откровенно
отличненько	отлично
преотлично	отлично
отрядик	отряд
отступленьице	отступление
охотничек	охотник
паденьице	падение
паечек	паек
препакостно	пакостно
пальмочка	пальма
развалюшка	развалюха
размышленьице	размышление
разрушеньице	разрушение
разрывчик	разрыв
ракушечка	ракушка
раненьице	ранение
раскосенький	раскосый
рассмотреньице	рассмотрение
широковатый	широкий
широковато	широко
шкварочка	шкварка
штурмовичок	штурмовик
шумновато	шумно
шумненько	шумно
щедроватый	щедрый
щербатенький	щербатый
эдиточка	Эдита
электромобильчик	электромобиль
электромоторчик	электромотор
Элечка	Элла
Эллочка	Элла
эстоночка	эстонка
юристочка	юристка
язычище	язык
яишенка	яичница
яичко	яйцо
ямочка	ямка
Яшенька	Яша
Яшка	Яша
веерочек	веер
венесуэлочка	венесуэлка
Верочка	Вера
верандочка	веранда
вербочка	верба
Вероничка	Вероника
верхушечка	верхушка
ветчинка	ветчина
вещичка	вещица
визгливенький	визгливый
виновничек	виновник
винтик	винт
витиеватенький	витиеватый
виточек	виток
витринка	витрина
Витька	Витя
Витенька	Витя
преизобильно	изобильно
икорка	икра
имечко	имя
интеллигентишка	интеллигент
интеллигентик	интеллигент
интеллигентненько	интеллигентно
преинтересно	интересно
интересненько	интересно
истомушка	истома
кадочка	кадка
календарик	календарь
калиточка	калитка
каналец	канал
канальчик	канал
ограниченьице	ограничение
однотипненько	однотипно
одноцветненько	одноцветно
озорноватый	озорной
окруженьице	окружение
обоссавшийся	описавшийся
описочка	описка
определеньице	определение
орденочек	орден
остроглазенький	остроглазый
проулочек	проулок
прыщичек	прыщик
прямохенько	прямо
прямехонько	прямо
пряменько	прямо
прямехенько	прямо
прямешенько	прямо
прямехонький	прямой
пряменький	прямой
психозик	психоз
пузастенький	пузастый
пузатенький	пузатый
путешественничек	путешественник
пушок	пух
пучеглазенький	пучеглазый
пушиночка	пушинка
пшеничка	пшеница
фрагментик	фрагмент
Фросечка	Фрося
хвостик	хвост
хиленько	хило
хиленький	хилый
хиловатый	хилый
хищничек	хищник
прехладнокровно	хладнокровно
хлопушечка	хлопушка
хомутик	хомут
хомячок	хомяк
художничек	художник
худосочненький	худосочный
хуеватенько	хуевато
хуторочек	хуторок
целочка	целка
цепочечка	цепочка
церковка	церковь
церквушка	церковь
чайничек	чайник
часочек	час
часик	час
частичка	частица
чекушечка	чекушка
челночек	челнок
чернявенький	чернявый
черпачок	черпак
честненький	честный
чижик	чиж
чинненько	чинно
чудненький	чудный
шалашик	шалаш
шалфейчик	шалфей
возгораньице	возгорание
волосатенький	волосатый
волшебничек	волшебник
извиненьице	извинение
израильтянка	израильтянин
изряднехонько	изрядно
изрядненько	изрядно
преизрядно	изрядно
иконка	икона
иконочка	икона
икорочка	икорка
именинничек	именинник
Инессочка	Инесса
Ириночка	Ира
Ирусечка	Ира
Иринка	Ира
Иришка	Ира
Ирочка	Ира
Иринушка	Ира
Ирмочка	Ирма
кабачок	кабак
кавайненько	кавайно
каемка	кайма
кальмарчик	кальмар
камеристочка	камеристка
камзольчик	камзол
окопчик	окоп
окорочок	окорок
окрошечка	окрошка
окурочек	окурок
опечаточка	опечатка
оркестрик	оркестр
осетринка	осетрина
особнячок	особняк
остросюжетненький	остросюжетный
островатый	острый
остренький	острый
простачок	простак
просторчик	простор
протеинчик	протеин
проходик	проход
прочненький	прочный
прощеньице	прощение
прутик	прут
пруточек	прут
пряжечка	пряжка
прямоугольничек	прямоугольник
пухловатый	пухлый
пухленький	пухлый
пылища	пыль
пятилеточка	пятилетка
фруктик	фрукт
халтурненько	халтурно
харизматичненько	харизматично
хитроватенько	хитровато
холодильничек	холодильник
холодочек	холодок
хохолочек	хохолок
хреноватый	хреновый
хреновенький	хреновый
целенький	целый
целехонький	целый
ценничек	ценник
чарочка	чарка
часовенка	часовня
чахленько	чахло
чернобровенький	чернобровый
чертик	черт
черточка	черта
четвертушечка	четвертушка
чуланчик	чулан
чулочек	чулок
шалунишка	шалун
шансик	шанс
шепотком	шепотом
шерстка	шерсть
березонька	береза
березка	береза
бесеночек	бесенок
билетик	билет
бодренько	бодро
болванчик	болван
больничка	больница
больноватый	больной
бородочка	бородка
Боренька	Боря
ботильончик	ботильон
боченочек	боченок
браслетик	браслет
брусочек	брусок
брюнеточка	брюнетка
бугорочек	бугорок
буксирчик	буксир
бумажечка	бумага
бумажка	бумага
буренушка	буренка
бюджетик	бюджет
Вадька	Вадим
Ванечка	Ваня
Ванюшка	Ваня
Ванька	Ваня
варварочка	Варвара
Варварушка	Варвара
ватрушечка	ватрушка
капиталец	капитал
капитальчик	капитал
капканчик	капкан
картинка	картина
картиночка	картина
кепочка	кепка
кепчонка	кепка
километрик	километр
кирпичик	кирпич
клейковатый	клейкий
коктейльчик	коктейль
колонночка	колонна
колыбелька	колыбель
комнатушка	комната
комнатка	комната
комнатенка	комната
отделочка	отделка
отельчик	отель
отрывочек	отрывок
офицерик	офицер
офицеришка	офицер
папашка	папаша
папашенька	папаша
папочкин	папин
парок	пар
разочек	раз
развеселенький	развеселый
развязочка	развязка
раздельчик	раздел
разудаленький	разудалый
раковинка	раковина
распашоночка	распашонка
распоряженьице	распоряжение
шиповничек	шиповник
школьничек	школьник
шкурочка	шкурка
шлюшка	шлюха
шляпка	шляпа
шортики	шорты
шпилечка	шпилька
щербиночка	щербинка
эклерчик	эклер
экранчик	экран
Эльзочка	Эльза
эмблемка	эмблема
эпизодик	эпизод
этикеточка	этикетка
Юрик	Юра
Юрчик	Юра
яблочко	яблоко
ядовитенько	ядовито
ядрененький	ядреный
атмосферненько	атмосферно
балахончик	балахон
бандочка	банда
баульчик	баул
башенка	башня
бедноватенький	бедноватый
бездарненький	бездарный
беззащитненький	беззащитный
безрукавочка	безрукавка
белочка	белка
белобрысенький	белобрысый
бельишко	белье
запретик	запрет
запросик	запрос
заседаньице	заседание
затхловатый	затхлый
зачетненько	зачетно
здоровенько	здорово
злобненький	злобный
злобноватенький	злобный
злобноватый	злобный
иголочка	игла
иголка	игла
Игоряша	Игорь
Гоша	Игорь
Игоречек	Игорь
игорек	Игорь
избушечка	избушка
извилинка	извилина
недоработочка	недоработка
неподмытенький	неподмытый
неполадочка	неполадка
неспокойненько	неспокойно
неудачка	неудача
нимфочка	нимфа
нимфеточка	нимфетка
Ниночка	Нина
похлебочка	похлебка
походочка	походочка
почечка	почка
правнучек	правнук
правенький	правый
практичненький	практичный
прапрадедушка	прапрадед
предпочтеньице	предпочтение
преотличненько	преотлично
преподобненький	преподобный
приветик	привет
телушка	телка
телочка	телка
тенечек	тень
тепличка	теплица
теплоходик	теплоход
терраска	терраса
тесненько	тесно
тесновато	тесно
теснехонько	тесно
теточка	тетя
тетечка	тетя
тетенька	тетя
тетушка	тетя
тихонький	тихий
тихохонький	тихий
толстоватенький	толстый
толстоватый	толстый
толстенький	толстый
тортик	торт
точненький	точный
точнехонький	точный
тошненько	тошно
тошнехонько	тошно
травиночка	травинка
тренировочка	тренировка
трончик	трон
трудненький	трудный
трудноватый	трудный
трясогузочка	трясогузка
туговатый	тугой
туманненько	туманно
туннельчик	туннель
туповато	тупо
тупенько	тупо
тускленький	тусклый
тускловатый	тусклый
тщеславненький	тщеславный
тятенька	тятя
ублюдочек	ублюдок
угловатенький	угловатый
уголочек	уголок
удовлетвореньице	удовлетворение
аккуратненько	аккуратно
аккуратенько	аккуратно
актрисочка	актриса
актриска	актриса
Лешка	Алексей
альбертик	Альберт
амурчик	Амур
анархисточка	анархистка
Толик	Анатолий
Толя	Анатолий
Толян	Анатолий
анекдотик	анекдот
Жоржик	Жорж
журавлик	журавль
журналисточка	журналистка
жутковатенько	жутковато
заварушка	заваруха
завиточек	завиток
задаточек	задаток
заключеньице	заключение
заложничек	заложник
заметочка	заметка
заминочка	заминка
замочек	замок
ножонка	нога
ножка	нога
ноженька	нога
ножища	нога
ноготочек	ноготок
Нонночка	Нонна
носастенький	носастый
обезьянка	обезьяна
обновочка	обновка
оборочка	оборка
обращеньице	обращение
обрядик	обряд
обстановочка	обстановка
объединеньице	объединение
оглядочка	оглядка
приметненький	приметный
припевочка	припевка
пробельчик	пробел
пробирочка	пробирка
пробочка	пробка
проводочек	проводок
продолговатенький	продолговатый
произведеньице	произведение
унитазик	унитаз
управленьице	управление
упряменький	упрямый
усик	ус
усищи	ус
усатенький	усатый
условьице	условие
уступочка	уступка
утеночек	утенок
фасолинка	фасолина
Феденька	Федя
Федька	Федя
Федюнька	Федя
финтифлюшечка	финтифлюшка
бережочек	бережок
блаженненько	блаженно
близехонько	близко
близенько	близко
блондинчик	блондин
блошка	блоха
блузка	блуза
бляшечка	бляшка
богомолочка	богомолка
боевичок	боевик
бочок	бок
бордовенький	бордовый
Зоечка	Зоя
Зоюшка	Зоя
недостаточек	недостаток
незабудочка	незабудка
немаленький	немалый
немолоденький	немолодой
неприметненький	неприметный
неслабенький	неслабый
посудинка	посудина
посылочка	посылка
потничек	потник
потолочек	потолок
початочек	початок
практиканточка	практикантка
превосходненько	превосходно
прибауточка	прибаутка
приборчик	прибор
пригоженький	пригожий
приказик	приказ
прикольненько	прикольно
тельце	тело
темочка	тема
темка	тема
теремок	терем
теремочек	теремок
теснотища	теснота
толстопопенький	толстопопый
толстопузенький	толстопузый
толстушка	толстуха
Томочка	Тома
тонночка	тонна
тостик	тост
треугольничек	треугольник
трибунка	трибуна
тритончик	тритон
тропка	тропка
тропочка	тропка
тростничок	тростник
трухлявенький	трухлявый
тужурочка	тужурка
тулупчик	тулуп
туманчик	туман
туманец	туман
тучноватый	тучный
тыковка	тыква
тыквочка	тыква
тюфячок	тюфяк
уборочка	уборка
угрюмоватый	угрюмый
удобненький	удобный
автобусик	автобус
адвокатик	адвокат
адвокатишка	адвокат
азотноватый	азотный
активненько	активно
Алешка	Алеша
Алешенька	Алеша
Альбиночка	Альбина
жеребеночек	жеребенок
жирафик	жираф
жлобоватый	жлобский
жопка	жопа
жопочка	жопа
Жорик	Жора
журналюга	журналист
заболеваньице	заболевание
заводик	завод
загогулинка	загогулина
загривочек	загривок
заказик	заказ
замечаньице	замечание
замечательненько	замечательно
ниточка	нить
ничегошеньки	ничего
ничтожненький	ничтожный
ножичек	ножик
нормочка	норма
носище	нос
носик	нос
ночничок	ночник
нянечка	няня
нянюшка	няня
обаяшечка	обаяшка
обивочка	обивка
обложечка	обложка
обсужденьице	обсуждение
обширненько	обширно
общеньице	общение
объемчик	объем
приметка	примета
приятненький	приятный
проборчик	пробор
проводок	провод
узенький	узкий
преузенький	узкий
узковатый	узкий
указик	указ
укропчик	укроп
улучшеньице	улучшение
улыбочка	улыбка
урожайчик	урожай
урывочками	урывками
уступчик	уступ
утвержденьице	утверждение
утречко	утро
преуютненько	уютно
уютненько	уютно
фасочка	фаска
флейтисточка	флейтистка
велосипедик	велосипед
велосипедисточка	велосипедистка
венгерочка	венгерка
Венька	Веня
весточка	весть
ветровочка	ветровка
вечерочек	вечерок
взросленький	взрослый
взрывчик	взрыв
виноградинка	виноградина
виньеточка	виньетка
вихрастенький	вихрастый
вкуснотища	вкуснятина
возочек	воз
волненьице	волнение
Изольдочка	Изольда
изящненький	изящный
Илюшка	Илья
Илюха	Илья
Илюша	Илья
именьице	имение
исполненьице	исполнение
кабинка	кабина
кабиночка	кабина
кабинетик	кабинет
кавардачок	кавардак
калиночка	калина
калинка	калина
огромненький	огромный
одеколончик	одеколон
озерко	озеро
озерцо	озеро
окошечко	окошко
орбитка	орбита
остановочка	остановка
остаточек	остаток
островок	остров
остроморденький	остромордый
прописочка	прописка
прорывчик	прорыв
прослоечка	прослойка
прочненько	прочно
прочнехонько	прочно
прялочка	прялка
пташка	птаха
птенчик	птенец
пультик	пульт
пуфик	пуф
пучочек	пучок
пыльноватый	пыльный
пыльненький	пыльный
пьеска	пьеса
радиомаячок	радиомаяк
футболочка	футболка
фуфаечка	фуфайка
халатик	халат
халявочка	халява
борзенько	борзо
бороздка	борозда
бровка	бровь
брутальненько	брутально
будочка	будка
бумажечка	бумажка
бумажонка	бумажка
бывальщинка	бывальщина
бычара	бык
бычок	бык
бюджетненько	бюджетно
вагиночка	вагина
канареечка	канарейка
канделябрик	канделябр
канистрочка	канистра
караванчик	караван
карандашик	карандаш
карапузик	карапуз
карманчик	карман
кармашек	карман
качалочка	качалка
каютка	каюта
квадратненький	квадратный
кикиморочка	кикимора
киношка	кино
кисленько	кисло
кляксочка	клякса
коброчка	кобра
колоколенка	колокольня
колхозничек	колхозник
колечко	кольцо
командочка	команда
комбинатик	комбинат
комбинашка	комбинация
коммуняка	коммунист
конкурентик	конкурент
конспективненько	конспективно
отголосочек	отголосок
отличничек	отличник
отпечаточек	отпечаток
отчетик	отчет
очкастенький	очкастый
ошметочек	ошметок
папенька	папа
папка	папа
папанька	папа
папуля	папа
папулька	папа
папулечка	папуля
разборочка	разборка
разненький	разный
ранка	рана
рассветик	рассвет
рассольчик	рассол
шифровочка	шифровка
шоферюга	шофер
штангочка	штанга
штанишки	штаны
штаники	штаны
штрафик	штраф
щеколдочка	щеколда
щелка	щель
щелочка	щель
щеночек	щенок
щепочка	щепка
Эдька	Эдуард
экипажик	экипаж
эмбриончик	эмбрион
эффектик	эффект
ягодка	ягода
ягодинка	ягода
Янка	Яна
Яночка	Яна
ярлычок	ярлык
ячеечка	ячейка
ячейка	ячейка
вежливенько	вежливо
вежливенький	вежливый
веселуха	веселье
вешалочка	вешалка
взгорочек	взгорок
видочек	видок
визиточка	визитка
вилочка	вилка
винцо	вино
внучечка	внучка
внученька	внучка
воблочка	вобла
волчара	волк
волчонок	волк
волчище	волк
Володечка	Володя
Володенька	Володя
Володька	Володя
изданьице	издание
издевочка	издевка
Илюшечка	Илюша
Илюшенька	Илюша
иномарочка	иномарка
интеллигентненький	интеллигентный
испаринка	испарина
испытаньице	испытание
калачик	калач
камешек	камень
камушек	камень
оперативненько	оперативно
осторожнехонько	осторожно
осторожненько	осторожно
отборчик	отбор
простоватенько	простовато
лох	простофиля
препротивно	противно
противненько	противно
процедурка	процедура
процентик	процент
прыщавенький	прыщавый
прыщеватый	прыщавый
прядка	прядь
прядочка	прядь
пуританочка	пуританка
пустяковенький	пустяковый
путничек	путник
пуховичок	пуховик
пышненько	пышно
работничек	работник
фраерочек	фраер
фургончик	фургон
хамоватенький	хамоватый
хитрющенький	хитрющий
хлорочка	хлорка
хмуроватый	хмурый
холодненький	холодный
холодноватый	холодный
хреноватенько	хреновато
хреноватенький	хреноватый
хрипленько	хрипло
хрипловато	хрипло
хроменький	хромой
хрящик	хрящ
худощавенький	худощавый
хуеватенький	хуевый
хуевенький	хуевый
хулиганчик	хулиган
царапинка	царапина
цветничок	цветник
частехонько	часто
частенько	часто
человечишка	человек
человечишко	человек
человечек	человек
человечище	человек
черепушка	череп
чиновничек	чиновник
шахматишки	шахматы
шашлычок	шашлык
шельмочка	шельма
хвастунишка	хвастун
херовато	херово
херовенько	херово
хижинка	хижина
хитрожопенький	хитрожопый
хозяюшка	хозяйка
холодненько	холодно
храбренький	храбрый
хрупковатый	хрупкий
худенький	худой
худюсенький	худой
прехуденький	худой
цветастенько	цветасто
цивильненько	цивильно
цыпленочек	цыпленок
челочка	челка
человечинка	человечина
черномазенький	черномазый
честненько	честно
честенько	честно
чудачок	чудак
чудесненький	чудесный
шарнирчик	шарнир
бечевка	бечева
бильярдик	бильярд
бирочка	бирка
бледнехонький	бледный
бледноватый	бледный
бледненький	бледный
блекленький	блеклый
блекловатый	блеклый
бляшка	бляха
богатенький	богатый
бокальчик	бокал
болоночка	болонка
большелобенький	большелобый
бордюрчик	бордюр
бормотунчик	бормотун
бравенько	браво
бражка	брага
бутылочка	бутылка
важненько	важно
преважно	важно
валентиночка	Валентина
вампирчик	вампир
варанчик	варан
Васька	Вася
Васечка	Вася
Васенька	Вася
ватничек	ватник
кандидатик	кандидат
кандидатурка	кандидатура
капелланчик	капеллан
Капитолиночка	Капитолина
капсулка	капсула
картиночка	картинка
картоночка	картонка
кафешка	кафе
кафтанчик	кафтан
кинотеатрик	кинотеатр
клиентик	клиент
клизмочка	клизма
клубничка	клубника
ключик	ключ
козлятушка	козел
козлик	козел
козявочка	козявка
колбочка	колба
колебаньице	колебание
колоритненько	колоритно
комбезик	комбез
конвертик	конверт
Костька	Константин
Костик	Константин
Костя	Константин
отметинка	отметина
отмычечка	отмычка
охотка	охота
ошибочка	ошибка
ощущеньице	ощущение
пакетик	пакет
палаточка	палатка
палисадничек	палисадник
пансиончик	пансион
радушненько	радушно
разведочка	разведка
разминочка	разминка
разочарованьице	разочарование
разрешеньице	разрешение
Раисочка	Раиса
расположеньице	расположение
распрекрасненький	распрекрасный
шляпочка	шляпка
шпоночка	шпонка
шрамик	шрам
штакетничек	штакетник
штырек	штырь
шустренький	шустрый
щепочка	щепа
щучка	щука
экспериментик	эксперимент
экспертизочка	экспертиза
Элька	Эля
Элечка	Эля
Эммочка	Эмма
эшелончик	эшелон
Юлька	Юля
явочка	явка
явленьице	явление
ялточка	Ялта
ямочка	яма
ямина	яма
японочка	японка
фляжка	фляга
фляжечка	фляга
формулировочка	формулировка
ведомостичка	ведомость
венчик	венец
веночек	венок
вернехонько	верно
вершинка	вершина
ветерочек	ветерок
ветхонький	ветхий
визитик	визит
витаминчик	витамин
витрина	витриночка
водопадик	водопад
волосик	волос
волосочек	волосок
Илоночка	Илона
инфернальненько	инфернально
Ириночка	Ирина
Иришечка	Ириша
исключеньице	исключение
преискусно	искусно
итальяшка	итальянец
кабриолетик	кабриолет
каморочка	каморка
огородик	огород
огрызочек	огрызок
одноклассничек	одноклассник
однокурсничек	однокурсник
одобреньице	одобрение
одутловатенький	одутловатый
окошко	окно
оконце	окно
округленький	округлый
окунек	окунь
олененочек	олененок
омуточек	омут
оптимистичненько	оптимистично
оранжисточка	оранжистка
освещеньице	освещение
основаньице	основание
оспинка	оспина
отважненький	отважный
проституточка	проститутка
простодушненький	простодушный
простецкий	простой
простенький	простой
простоватый	простой
протокольчик	протокол
прыщик	прыщ
птичка	птица
пугливенький	пугливый
пуделечек	пуделек
пустовато	пусто
пустенько	пусто
пустячок	пустяк
пыточка	пытка
пятерочка	пятерка
пятнашечка	пятнашка
пятнышко	пятно
французик	француз
французишка	француз
фужерчик	фужер
футбольчик	футбол
футлярчик	футляр
хворенький	хворый
хвостатенький	хвостатый
хлипковатый	хлипкий
хлипенький	хлипкий
хмуровато	хмуро
холодок	холод
холодище	холод
пиздатый	хороший
хорошенький	хороший
хохмочка	хохма
храненьице	хранение
царек	царь
чашечка	чашка
червоточинка	червоточина
четенько	четко
чехольчик	чехол
чубик	чуб
чубчик	чуб
шампурчик	шампур
шарик	шар
шарфик	шарф
шепелявенький	шепелявый
берет	беретик
бесенок	бес
беспорядочек	беспорядок
бисквитик	бисквит
благоразумненький	благоразумный
бледноватенько	бледно
бледновато	бледно
бледненько	бледно
блондиночка	блондинка
бодренький	бодрый
болезненький	болезненный
большеглазенький	большеглазый
большеватый	большой
Бориска	Борис
босенький	босой
ботиночек	ботинок
бочоночек	бочонок
бригадочка	бригада
бритенький	бритый
брошюрка	брошюра
букашечка	букашка
булочка	булка
бульончик	бульон
бурундучок	бурундук
бусиночка	бусинка
быстренько	быстро
быстрехонько	быстро
Валерочка	Валера
Валечка	Валя
вампирочка	вампирка
вареничек	вареник
Варька	Варя
Варечка	Варя
Варюша	Варя
Варенька	Варя
Карменситочка	Карменсита
кастрюлька	кастрюля
квадратик	квадрат
квартирка	квартира
квартирочка	квартира
кибиточка	кибитка
кивочек	кивок
килограммчик	килограмм
кипяточек	кипяток
китаяночка	китаянка
Клавдюшечка	Клавдия
книжечка	книжка
козыречек	козырек
колбаска	колбаса
колдунишка	колдун
колесико	колесо
колодочка	колода
колотушечка	колотушка
комитетик	комитет
комочек	комок
конопляночка	коноплянка
контрактик	контракт
контрамарочка	контрамарка
отговорочка	отговорка
отделеньице	отделение
пиздатый	отличный
отличненький	отличный
отметочка	отметка
официанточка	официантка
очечки	очки
ошейничек	ошейник
Павлушка	Павел
пантерочка	пантера
развилочка	развилка
разговорчик	разговор
разлюбезненький	разлюбезный
размещеньице	размещение
разнесчастненький	разнесчастный
разумненько	разумно
разумненький	разумный
рановато	рано
раненько	рано
ранешенько	рано
ранехонько	рано
шишечка	шишка
шкурка	шкура
шуточка	шутка
щечка	щека
экипировочка	экипировка
элементик	элемент
Эсмеральдочка	Эсмеральда
этажерочка	этажерка
юбочка	юбка
юбчонка	юбка
язвина	язва
язвочка	язва
язвинка	язва
якорек	якорь
яхточка	яхта
